Player,ACS,K,D,A,KD_DIFF,ADR,HS%,FK,FD,FK_FD_DIFF,match_id,Team,Opp_Team,Map,Num_maps,Patch
tuyz,250,52,42,18,10,170.1,18,5,5,0,6527,IMP,paiN,MATCH,3,
txddy,238,51,44,9,7,146.2,27,3,8,-5,6527,IMP,paiN,MATCH,3,
Biscoit1n,192,44,49,4,-5,102.9,16,8,14,-6,6527,IMP,paiN,MATCH,3,
rst,172,32,41,20,-9,120.3,15,3,8,-5,6527,IMP,paiN,MATCH,3,
Evilkyk,162,35,46,18,-11,104.3,15,2,6,-4,6527,IMP,paiN,MATCH,3,
kon4n,244,52,35,23,17,161.6,25,5,2,3,6527,paiN,IMP,MATCH,3,
Txozin,244,57,43,6,14,145.3,32,7,3,4,6527,paiN,IMP,MATCH,3,
murizzz,211,37,49,23,-12,132.7,20,12,4,8,6527,paiN,IMP,MATCH,3,
Veroneze,183,39,44,11,-5,128.5,29,8,6,2,6527,paiN,IMP,MATCH,3,
matheuzin,160,37,43,4,-6,103.1,28,9,6,3,6527,paiN,IMP,MATCH,3,
tuyz,250,52,42,18,10,170.1,18,5,5,0,6527,IMP,paiN,MATCH,3,
txddy,238,51,44,9,7,146.2,27,3,8,-5,6527,IMP,paiN,MATCH,3,
Biscoit1n,192,44,49,4,-5,102.9,16,8,14,-6,6527,IMP,paiN,MATCH,3,
rst,172,32,41,20,-9,120.3,15,3,8,-5,6527,IMP,paiN,MATCH,3,
Evilkyk,162,35,46,18,-11,104.3,15,2,6,-4,6527,IMP,paiN,MATCH,3,
kon4n,244,52,35,23,17,161.6,25,5,2,3,6527,paiN,IMP,MATCH,3,
Txozin,244,57,43,6,14,145.3,32,7,3,4,6527,paiN,IMP,MATCH,3,
murizzz,211,37,49,23,-12,132.7,20,12,4,8,6527,paiN,IMP,MATCH,3,
Veroneze,183,39,44,11,-5,128.5,29,8,6,2,6527,paiN,IMP,MATCH,3,
matheuzin,160,37,43,4,-6,103.1,28,9,6,3,6527,paiN,IMP,MATCH,3,
rst,229,42,33,16,9,165.4,19,2,1,1,6053,IMP,oNe,MATCH,2,1.12
tuyz,222,39,39,10,0,127.6,19,5,4,1,6053,IMP,oNe,MATCH,2,1.12
txddy,217,40,42,12,-2,132.2,22,8,4,4,6053,IMP,oNe,MATCH,2,1.12
Evilkyk,216,41,37,9,4,134.1,21,4,7,-3,6053,IMP,oNe,MATCH,2,1.12
Biscoit1n,176,33,35,10,-2,115.1,24,7,11,-4,6053,IMP,oNe,MATCH,2,1.12
ntk,230,40,38,12,2,147.5,15,5,5,0,6053,oNe,IMP,MATCH,2,1.12
Cpx,226,40,44,9,-4,152.4,17,9,6,3,6053,oNe,IMP,MATCH,2,1.12
Maverick,226,39,39,19,0,142.0,18,9,7,2,6053,oNe,IMP,MATCH,2,1.12
Zap,184,37,34,5,3,104.1,25,2,5,-3,6053,oNe,IMP,MATCH,2,1.12
Champzera,172,30,40,10,-10,116.6,18,2,3,-1,6053,oNe,IMP,MATCH,2,1.12
Sacy,263,55,43,15,12,194.2,33,3,10,-7,5284,RED,Mix,MATCH,3,1.12
pepa,209,41,46,11,-5,146.3,24,7,9,-2,5284,RED,Mix,MATCH,3,1.12
pollo,188,41,42,17,-1,129.7,23,3,2,1,5284,RED,Mix,MATCH,3,1.12
Masu,169,39,40,10,-1,104.6,28,2,7,-5,5284,RED,Mix,MATCH,3,1.12
prozin,147,27,47,13,-20,95.4,15,5,11,-6,5284,RED,Mix,MATCH,3,1.12
Evilkyk,271,58,40,10,18,164.5,25,9,4,5,5284,Mix,RED,MATCH,3,1.12
Biscoit1n,252,52,42,10,10,136.3,20,14,6,8,5284,Mix,RED,MATCH,3,1.12
tuyz,217,42,40,16,2,132.4,16,8,3,5,5284,Mix,RED,MATCH,3,1.12
txddy,171,35,41,14,-6,95.9,18,5,2,3,5284,Mix,RED,MATCH,3,1.12
rst,148,31,40,10,-9,98.6,23,3,5,-2,5284,Mix,RED,MATCH,3,1.12
txddy,224,35,19,4,16,129.0,23,3,1,2,5276,Mix,novi,MATCH,2,1.12
tuyz,223,33,25,8,8,129.4,21,8,3,5,5276,Mix,novi,MATCH,2,1.12
Biscoit1n,215,29,28,8,1,121.9,19,9,7,2,5276,Mix,novi,MATCH,2,1.12
Evilkyk,210,30,22,14,8,127.2,22,6,1,5,5276,Mix,novi,MATCH,2,1.12
rst,176,30,24,4,6,100.1,17,1,2,-1,5276,Mix,novi,MATCH,2,1.12
Enjoy,198,26,32,8,-6,149.6,18,1,3,-2,5276,novi,Mix,MATCH,2,1.12
surpriiseeee,190,25,33,9,-8,123.7,20,5,6,-1,5276,novi,Mix,MATCH,2,1.12
vett,183,28,27,7,1,125.7,23,3,6,-3,5276,novi,Mix,MATCH,2,1.12
phz,167,22,34,11,-12,107.2,13,2,5,-3,5276,novi,Mix,MATCH,2,1.12
cooK,127,17,31,9,-14,103.3,23,3,7,-4,5276,novi,Mix,MATCH,2,1.12
h1d0,205,23,32,2,-9,127.4,34,6,6,0,5173,Real,Mix,MATCH,2,1.1
guiih9,151,15,28,9,-13,101.4,16,1,4,-3,5173,Real,Mix,MATCH,2,1.1
panzol,151,16,29,4,-13,93.4,14,2,2,0,5173,Real,Mix,MATCH,2,1.1
inq,133,16,28,6,-12,79.2,18,2,5,-3,5173,Real,Mix,MATCH,2,1.1
Phobia,128,12,29,3,-17,84.4,22,1,4,-3,5173,Real,Mix,MATCH,2,1.1
tuyz,286,34,14,11,20,176.3,26,2,3,-1,5173,Mix,Real,MATCH,2,1.1
Evilkyk,263,32,15,15,17,159.6,14,4,1,3,5173,Mix,Real,MATCH,2,1.1
Biscoit1n,247,32,22,5,10,140.6,18,8,6,2,5173,Mix,Real,MATCH,2,1.1
rst,229,28,12,11,16,135.8,16,4,1,3,5173,Mix,Real,MATCH,2,1.1
txddy,186,20,19,8,1,102.9,19,3,1,2,5173,Mix,Real,MATCH,2,1.1
Biscoit1n,255,20,11,4,9,141.7,22,5,5,0,5024,Mix,FazT,MATCH,1,1.1
tuyz,249,19,12,4,7,144.5,20,2,4,-2,5024,Mix,FazT,MATCH,1,1.1
Evilkyk,231,16,15,10,1,125.0,15,1,0,1,5024,Mix,FazT,MATCH,1,1.1
txddy,219,16,14,8,2,133.5,24,3,1,2,5024,Mix,FazT,MATCH,1,1.1
rst,137,11,9,7,2,92.2,10,0,0,0,5024,Mix,FazT,MATCH,1,1.1
RgLMeister,263,18,15,2,3,193.0,21,1,0,1,5024,FazT,Mix,MATCH,1,1.1
raddy,176,12,18,3,-6,116.6,17,3,4,-1,5024,FazT,Mix,MATCH,1,1.1
Fxw,171,12,17,1,-5,123.2,12,4,4,0,5024,FazT,Mix,MATCH,1,1.1
UmRastaGG,165,11,16,2,-5,122.9,38,1,1,0,5024,FazT,Mix,MATCH,1,1.1
shok9,120,8,16,5,-8,73.8,8,1,2,-1,5024,FazT,Mix,MATCH,1,1.1
patochovsk,227,90,80,29,10,162.0,14,15,18,-3,4976,Vivo,Mix,MATCH,5,1.1
NikkoLAN,218,88,87,15,1,134.5,19,22,18,4,4976,Vivo,Mix,MATCH,5,1.1
flainzz,208,90,74,24,16,121.3,18,6,6,0,4976,Vivo,Mix,MATCH,5,1.1
NANZIN,207,88,79,22,9,133.0,34,10,15,-5,4976,Vivo,Mix,MATCH,5,1.1
FLG1,187,83,80,28,3,121.4,22,5,6,-1,4976,Vivo,Mix,MATCH,5,1.1
txddy,233,100,90,23,10,135.4,22,11,8,3,4976,Mix,Vivo,MATCH,5,1.1
tuyz,207,85,84,27,1,137.4,16,11,10,1,4976,Mix,Vivo,MATCH,5,1.1
Biscoit1n,200,83,96,26,-13,117.4,17,30,26,4,4976,Mix,Vivo,MATCH,5,1.1
Evilkyk,191,79,89,33,-10,135.3,18,9,6,3,4976,Mix,Vivo,MATCH,5,1.1
rst,132,53,80,26,-27,96.4,19,2,8,-6,4976,Mix,Vivo,MATCH,5,1.1
LEozin,232,38,32,3,6,127.7,21,10,1,9,4943,BD,Mix,MATCH,2,1.1
wilfps,209,33,34,7,-1,141.8,24,5,6,-1,4943,BD,Mix,MATCH,2,1.1
rhz,199,31,30,16,1,118.8,24,1,1,0,4943,BD,Mix,MATCH,2,1.1
rood,177,27,28,14,-1,110.1,15,6,4,2,4943,BD,Mix,MATCH,2,1.1
bezn1,138,17,35,15,-18,90.9,19,2,9,-7,4943,BD,Mix,MATCH,2,1.1
Biscoit1n,250,38,31,12,7,165.3,23,6,6,0,4943,Mix,BD,MATCH,2,1.1
txddy,219,37,27,7,10,124.0,25,3,4,-1,4943,Mix,BD,MATCH,2,1.1
Evilkyk,195,30,29,8,1,129.6,18,3,8,-5,4943,Mix,BD,MATCH,2,1.1
rst,191,32,27,7,5,113.7,17,4,3,1,4943,Mix,BD,MATCH,2,1.1
tuyz,158,22,32,15,-10,105.5,21,5,3,2,4943,Mix,BD,MATCH,2,1.1
deNaro,250,16,15,3,1,158.8,29,2,2,0,4906,VKS,Mix,MATCH,1,1.11
cad,211,12,17,3,-5,113.4,19,2,3,-1,4906,VKS,Mix,MATCH,1,1.11
gtnziN,132,8,16,3,-8,80.6,29,2,3,-1,4906,VKS,Mix,MATCH,1,1.11
BrinkssJ,118,6,14,6,-8,77.3,21,1,2,-1,4906,VKS,Mix,MATCH,1,1.11
fuzari,83,4,16,5,-12,65.9,10,0,1,-1,4906,VKS,Mix,MATCH,1,1.11
Biscoit1n,352,23,10,3,13,180.1,14,6,1,5,4906,Mix,VKS,MATCH,1,1.11
txddy,261,17,10,5,7,151.1,18,1,3,-2,4906,Mix,VKS,MATCH,1,1.11
Evilkyk,244,15,8,7,7,149.5,14,3,2,1,4906,Mix,VKS,MATCH,1,1.11
tuyz,204,12,9,3,3,126.6,24,1,1,0,4906,Mix,VKS,MATCH,1,1.11
rst,131,11,9,2,2,83.1,23,0,0,0,4906,Mix,VKS,MATCH,1,1.11
Biscoit1n,241,56,46,3,10,134.0,18,15,11,4,4702,Mix,FF,MATCH,3,1.1
tuyz,231,51,43,16,8,139.4,19,2,6,-4,4702,Mix,FF,MATCH,3,1.1
rst,203,51,41,7,10,124.4,23,5,8,-3,4702,Mix,FF,MATCH,3,1.1
txddy,181,38,46,16,-8,113.2,19,7,4,3,4702,Mix,FF,MATCH,3,1.1
Evilkyk,148,30,40,18,-10,108.3,15,2,5,-3,4702,Mix,FF,MATCH,3,1.1
fzkk,230,47,51,19,-4,144.3,13,14,13,1,4702,FF,Mix,MATCH,3,1.1
krain,201,47,41,25,6,119.9,12,6,1,5,4702,FF,Mix,MATCH,3,1.1
v1xen,181,43,46,20,-3,108.8,25,5,7,-2,4702,FF,Mix,MATCH,3,1.1
dragonite,176,40,41,15,-1,108.0,16,3,1,2,4702,FF,Mix,MATCH,3,1.1
delevingne,172,38,49,13,-11,112.6,12,6,9,-3,4702,FF,Mix,MATCH,3,1.1
Biscoit1n,236,53,55,18,-2,133.9,24,10,10,0,4700,Mix,C,MATCH,3,1.1
tuyz,214,52,53,5,-1,131.4,20,6,5,1,4700,Mix,C,MATCH,3,1.1
Evilkyk,213,49,47,22,2,142.2,16,7,7,0,4700,Mix,C,MATCH,3,1.1
txddy,179,39,42,19,-3,120.3,20,9,5,4,4700,Mix,C,MATCH,3,1.1
rst,178,48,45,15,3,102.7,19,7,3,4,4700,Mix,C,MATCH,3,1.1
gustt1nha,254,59,48,24,11,172.3,23,5,1,4,4700,C,Mix,MATCH,3,1.1
tHeLiFeSnAkE,233,53,52,11,1,157.3,23,7,8,-1,4700,C,Mix,MATCH,3,1.1
AimGreen,209,51,43,15,8,140.2,27,9,6,3,4700,C,Mix,MATCH,3,1.1
sutecas,170,41,52,15,-11,117.3,32,7,14,-7,4700,C,Mix,MATCH,3,1.1
LEAN,140,37,49,7,-12,85.4,28,2,10,-8,4700,C,Mix,MATCH,3,1.1
tuyz,242,41,31,13,10,142.0,20,8,9,-1,4629,Mix,paiN,MATCH,3,1.1
Evilkyk,237,40,33,18,7,144.0,21,9,2,7,4629,Mix,paiN,MATCH,3,1.1
txddy,231,42,31,14,11,142.4,19,5,3,2,4629,Mix,paiN,MATCH,3,1.1
Biscoit1n,219,40,32,11,8,119.4,22,7,5,2,4629,Mix,paiN,MATCH,3,1.1
rst,156,33,28,10,5,105.2,19,2,1,1,4629,Mix,paiN,MATCH,3,1.1
kon4n,209,38,40,9,-2,130.0,25,6,6,0,4629,paiN,Mix,MATCH,3,1.1
murizzz,198,33,43,10,-10,121.7,19,7,11,-4,4629,paiN,Mix,MATCH,3,1.1
matheuzin,170,32,40,10,-8,105.1,22,3,5,-2,4629,paiN,Mix,MATCH,3,1.1
ole,152,26,39,9,-13,97.3,16,2,6,-4,4629,paiN,Mix,MATCH,3,1.1
Txozin,145,26,35,8,-9,117.4,30,2,3,-1,4629,paiN,Mix,MATCH,3,1.1
deNaro,213,16,17,6,-1,165.0,16,1,5,-4,4620,VKS,Mix,MATCH,1,1.1
gtnziN,173,13,15,3,-2,162.8,23,0,2,-2,4620,VKS,Mix,MATCH,1,1.1
cad,148,10,16,3,-6,97.2,14,3,6,-3,4620,VKS,Mix,MATCH,1,1.1
BrinkssJ,135,10,15,8,-5,170.4,17,2,0,2,4620,VKS,Mix,MATCH,1,1.1
fuzari,92,8,15,2,-7,65.3,22,0,4,-4,4620,VKS,Mix,MATCH,1,1.1
Biscoit1n,223,18,15,2,3,139.5,17,8,1,7,4620,Mix,VKS,MATCH,1,1.1
tuyz,208,15,11,5,4,136.3,24,1,3,-2,4620,Mix,VKS,MATCH,1,1.1
txddy,188,17,11,9,6,124.0,39,2,0,2,4620,Mix,VKS,MATCH,1,1.1
Evilkyk,171,14,13,7,1,81.5,32,4,1,3,4620,Mix,VKS,MATCH,1,1.1
rst,116,10,8,11,2,120.3,14,2,1,1,4620,Mix,VKS,MATCH,1,1.1
gtnziN,264,75,48,20,27,157.5,13,11,10,1,8298,VKS,IMP,MATCH,4,
sutecas,235,66,49,21,17,149.9,20,8,4,4,8298,VKS,IMP,MATCH,4,
frz,233,60,48,29,12,130.9,28,13,9,4,8298,VKS,IMP,MATCH,4,
saadhak,211,58,45,31,13,137.7,18,7,9,-2,8298,VKS,IMP,MATCH,4,
Sacy,194,55,45,30,10,134.6,26,7,1,6,8298,VKS,IMP,MATCH,4,
gustt1nha,227,61,59,16,2,148.3,18,7,9,-2,8298,IMP,VKS,MATCH,4,
Evilkyk,204,52,70,19,-18,134.4,29,6,6,0,8298,IMP,VKS,MATCH,4,
Biscoit1n,174,48,60,15,-12,114.1,18,4,8,-4,8298,IMP,VKS,MATCH,4,
rst,145,39,58,17,-19,115.4,17,7,5,2,8298,IMP,VKS,MATCH,4,
tuyz,137,35,67,11,-32,97.7,28,9,18,-9,8298,IMP,VKS,MATCH,4,
Evilkyk,246,41,30,19,11,183.7,29,6,3,3,8297,IMP,BD,MATCH,2,
tuyz,242,42,33,3,9,166.9,31,7,7,0,8297,IMP,BD,MATCH,2,
gustt1nha,216,34,36,13,-2,137.7,16,4,7,-3,8297,IMP,BD,MATCH,2,
Biscoit1n,211,34,29,12,5,129.8,30,3,6,-3,8297,IMP,BD,MATCH,2,
rst,173,28,29,12,-1,102.1,17,0,4,-4,8297,IMP,BD,MATCH,2,
pollo,223,39,35,5,4,146.0,28,13,4,9,8297,BD,IMP,MATCH,2,
bezn1,222,33,37,22,-4,150.2,24,1,1,0,8297,BD,IMP,MATCH,2,
LEozin,214,32,39,15,-7,137.7,16,8,6,2,8297,BD,IMP,MATCH,2,
rood,183,29,33,10,-4,126.5,14,4,3,1,8297,BD,IMP,MATCH,2,
wilfps,150,24,35,20,-11,92.1,17,1,6,-5,8297,BD,IMP,MATCH,2,
tuyz,316,43,25,9,18,174.6,21,14,4,10,8246,IMP,CONC,MATCH,2,1.14
gustt1nha,250,36,23,7,13,147.2,21,4,6,-2,8246,IMP,CONC,MATCH,2,1.14
Evilkyk,249,33,22,16,11,158.0,25,5,2,3,8246,IMP,CONC,MATCH,2,1.14
Biscoit1n,163,24,21,13,3,107.4,25,2,0,2,8246,IMP,CONC,MATCH,2,1.14
rst,153,24,17,13,7,127.0,20,1,1,0,8246,IMP,CONC,MATCH,2,1.14
DEK,211,33,29,1,4,121.5,18,4,8,-4,8246,CONC,IMP,MATCH,2,1.14
gTTO,186,20,31,11,-11,130.2,15,4,3,1,8246,CONC,IMP,MATCH,2,1.14
matxd,163,21,32,7,-11,114.7,12,0,4,-4,8246,CONC,IMP,MATCH,2,1.14
shawk,144,17,36,9,-19,84.6,9,3,5,-2,8246,CONC,IMP,MATCH,2,1.14
taek,133,16,32,6,-16,78.0,17,2,6,-4,8246,CONC,IMP,MATCH,2,1.14
Evilkyk,319,25,12,5,13,199.2,36,6,3,3,8236,IMP,Bimb,MATCH,1,1.14
gustt1nha,249,15,16,9,-1,170.7,26,1,2,-1,8236,IMP,Bimb,MATCH,1,1.14
tuyz,237,19,11,3,8,143.5,30,3,1,2,8236,IMP,Bimb,MATCH,1,1.14
Biscoit1n,193,17,13,6,4,119.0,24,4,1,3,8236,IMP,Bimb,MATCH,1,1.14
rst,73,6,11,3,-5,82.5,8,0,1,-1,8236,IMP,Bimb,MATCH,1,1.14
cortezia,334,23,17,5,6,187.5,17,6,4,2,8236,Bimb,IMP,MATCH,1,1.14
strnx,201,16,14,5,2,132.2,14,0,2,-2,8236,Bimb,IMP,MATCH,1,1.14
Warchaoz,198,16,14,1,2,117.1,14,2,3,-1,8236,Bimb,IMP,MATCH,1,1.14
spartaN,91,6,20,4,-14,57.1,17,0,3,-3,8236,Bimb,IMP,MATCH,1,1.14
smz,67,2,17,4,-15,56.8,8,0,2,-2,8236,Bimb,IMP,MATCH,1,1.14
rhamurti,242,34,33,14,1,153.5,21,5,5,0,9426,DLWZK,IMP,MATCH,2,2.01
BRNWOWZK1,202,25,33,14,-8,140.0,15,1,5,-4,9426,DLWZK,IMP,MATCH,2,2.01
heat,194,31,33,5,-2,122.1,36,3,7,-4,9426,DLWZK,IMP,MATCH,2,2.01
fluyr,175,23,36,12,-13,112.5,12,3,5,-2,9426,DLWZK,IMP,MATCH,2,2.01
zam,136,21,34,6,-13,96.2,20,3,5,-2,9426,DLWZK,IMP,MATCH,2,2.01
Evilkyk,321,45,24,18,21,193.3,32,12,5,7,9426,IMP,DLWZK,MATCH,2,2.01
tuyz,296,46,29,11,17,183.5,27,6,3,3,9426,IMP,DLWZK,MATCH,2,2.01
rst,178,29,22,10,7,129.7,12,2,3,-1,9426,IMP,DLWZK,MATCH,2,2.01
Biscoit1n,172,22,33,15,-11,103.0,21,6,4,2,9426,IMP,DLWZK,MATCH,2,2.01
gustt1nha,163,27,26,14,1,99.7,22,1,0,1,9426,IMP,DLWZK,MATCH,2,2.01
tuyz,270,16,18,4,-2,175.2,24,5,1,4,9260,IMP,VKS,MATCH,1,2.01
Evilkyk,193,12,16,5,-4,135.2,32,0,2,-2,9260,IMP,VKS,MATCH,1,2.01
Biscoit1n,164,10,16,3,-6,108.6,38,3,5,-2,9260,IMP,VKS,MATCH,1,2.01
gustt1nha,149,10,15,5,-5,85.9,22,0,1,-1,9260,IMP,VKS,MATCH,1,2.01
rst,138,9,15,1,-6,75.4,7,1,1,0,9260,IMP,VKS,MATCH,1,2.01
saadhak,260,16,9,7,7,171.5,16,1,0,1,9260,VKS,IMP,MATCH,1,2.01
sutecas,258,19,14,7,5,148.7,16,1,2,-1,9260,VKS,IMP,MATCH,1,2.01
Sacy,236,19,9,9,10,139.3,19,4,0,4,9260,VKS,IMP,MATCH,1,2.01
gtnziN,212,13,13,10,0,150.5,21,0,3,-3,9260,VKS,IMP,MATCH,1,2.01
frz,181,13,12,7,1,99.1,16,4,4,0,9260,VKS,IMP,MATCH,1,2.01
Evilkyk,259,52,35,18,17,162.4,41,5,3,2,9104,IMP,fave,MATCH,2,2.01
tuyz,231,41,39,12,2,137.7,25,16,7,9,9104,IMP,fave,MATCH,2,2.01
rst,211,43,30,17,13,148.5,14,2,4,-2,9104,IMP,fave,MATCH,2,2.01
Biscoit1n,176,34,37,10,-3,105.3,17,2,5,-3,9104,IMP,fave,MATCH,2,2.01
gustt1nha,167,27,43,18,-16,114.9,17,3,7,-4,9104,IMP,fave,MATCH,2,2.01
aspas,304,57,40,13,17,193.6,26,8,7,1,9104,fave,IMP,MATCH,2,2.01
Nether,240,46,39,12,7,156.3,33,7,6,1,9104,fave,IMP,MATCH,2,2.01
cad,181,33,41,7,-8,121.5,17,7,8,-1,9104,fave,IMP,MATCH,2,2.01
prince,171,28,39,21,-11,136.8,21,3,3,0,9104,fave,IMP,MATCH,2,2.01
akemy,106,20,38,5,-18,76.4,24,1,4,-3,9104,fave,IMP,MATCH,2,2.01
tuyz,270,16,18,4,-2,175.2,24,5,1,4,9260,IMP,VKS,MATCH,1,2.01
Evilkyk,193,12,16,5,-4,135.2,32,0,2,-2,9260,IMP,VKS,MATCH,1,2.01
Biscoit1n,164,10,16,3,-6,108.6,38,3,5,-2,9260,IMP,VKS,MATCH,1,2.01
gustt1nha,149,10,15,5,-5,85.9,22,0,1,-1,9260,IMP,VKS,MATCH,1,2.01
rst,138,9,15,1,-6,75.4,7,1,1,0,9260,IMP,VKS,MATCH,1,2.01
saadhak,260,16,9,7,7,171.5,16,1,0,1,9260,VKS,IMP,MATCH,1,2.01
sutecas,258,19,14,7,5,148.7,16,1,2,-1,9260,VKS,IMP,MATCH,1,2.01
Sacy,236,19,9,9,10,139.3,19,4,0,4,9260,VKS,IMP,MATCH,1,2.01
gtnziN,212,13,13,10,0,150.5,21,0,3,-3,9260,VKS,IMP,MATCH,1,2.01
frz,181,13,12,7,1,99.1,16,4,4,0,9260,VKS,IMP,MATCH,1,2.01
rhamurti,242,34,33,14,1,153.5,21,5,5,0,9426,DLWZK,IMP,MATCH,2,2.01
BRNWOWZK1,202,25,33,14,-8,140.0,15,1,5,-4,9426,DLWZK,IMP,MATCH,2,2.01
heat,194,31,33,5,-2,122.1,36,3,7,-4,9426,DLWZK,IMP,MATCH,2,2.01
fluyr,175,23,36,12,-13,112.5,12,3,5,-2,9426,DLWZK,IMP,MATCH,2,2.01
zam,136,21,34,6,-13,96.2,20,3,5,-2,9426,DLWZK,IMP,MATCH,2,2.01
Evilkyk,321,45,24,18,21,193.3,32,12,5,7,9426,IMP,DLWZK,MATCH,2,2.01
tuyz,296,46,29,11,17,183.5,27,6,3,3,9426,IMP,DLWZK,MATCH,2,2.01
rst,178,29,22,10,7,129.7,12,2,3,-1,9426,IMP,DLWZK,MATCH,2,2.01
Biscoit1n,172,22,33,15,-11,103.0,21,6,4,2,9426,IMP,DLWZK,MATCH,2,2.01
gustt1nha,163,27,26,14,1,99.7,22,1,0,1,9426,IMP,DLWZK,MATCH,2,2.01
deNaro,221,41,39,24,2,149.7,15,4,3,1,9427,S5,IMP,MATCH,2,2.01
gaabxx,210,43,39,6,4,135.4,26,11,5,6,9427,S5,IMP,MATCH,2,2.01
prozin,205,40,44,15,-4,127.0,17,8,6,2,9427,S5,IMP,MATCH,2,2.01
fooX,191,41,41,11,0,134.6,18,3,4,-1,9427,S5,IMP,MATCH,2,2.01
fra,181,36,46,13,-10,107.8,16,6,8,-2,9427,S5,IMP,MATCH,2,2.01
tuyz,277,53,39,18,14,167.9,31,2,4,-2,9427,IMP,S5,MATCH,2,2.01
Evilkyk,237,48,37,17,11,178.2,44,7,5,2,9427,IMP,S5,MATCH,2,2.01
Biscoit1n,206,40,48,12,-8,146.7,26,15,13,2,9427,IMP,S5,MATCH,2,2.01
rst,193,39,38,13,1,128.0,26,1,6,-5,9427,IMP,S5,MATCH,2,2.01
gustt1nha,148,29,39,13,-10,100.3,26,1,4,-3,9427,IMP,S5,MATCH,2,2.01
gustt1nha,274,16,9,9,7,141.9,26,3,0,3,10286,IMP,S5,MATCH,1,2.02
rst,269,14,8,4,6,164.8,24,3,2,1,10286,IMP,S5,MATCH,1,2.02
tuyz,250,14,8,0,6,144.6,22,1,1,0,10286,IMP,S5,MATCH,1,2.02
Evilkyk,211,12,8,6,4,150.4,48,0,1,-1,10286,IMP,S5,MATCH,1,2.02
Biscoit1n,199,11,9,3,2,128.1,29,1,3,-2,10286,IMP,S5,MATCH,1,2.02
prozin,222,13,13,2,0,118.2,23,1,3,-2,10286,S5,IMP,MATCH,1,2.02
deNaro,172,8,14,0,-6,114.5,21,2,1,1,10286,S5,IMP,MATCH,1,2.02
gaabxx,154,7,13,6,-6,98.5,28,2,1,1,10286,S5,IMP,MATCH,1,2.02
fra,152,7,13,2,-6,94.0,22,1,2,-1,10286,S5,IMP,MATCH,1,2.02
light,152,7,14,4,-7,107.4,21,1,1,0,10286,S5,IMP,MATCH,1,2.02
mwzera,315,22,13,7,9,256.0,18,5,1,4,10306,GL,IMP,MATCH,1,2.02
Nyang,234,19,12,9,7,148.0,16,2,1,1,10306,GL,IMP,MATCH,1,2.02
Jonn,195,14,15,4,-1,147.3,25,3,3,0,10306,GL,IMP,MATCH,1,2.02
fznnn,193,15,11,5,4,107.3,6,1,1,0,10306,GL,IMP,MATCH,1,2.02
JhoW,193,13,15,5,-2,106.2,10,3,1,2,10306,GL,IMP,MATCH,1,2.02
Evilkyk,268,18,18,8,0,152.0,28,1,1,0,10306,IMP,GL,MATCH,1,2.02
rst,215,16,16,3,0,127.4,12,4,3,1,10306,IMP,GL,MATCH,1,2.02
tuyz,192,15,14,7,1,126.2,26,1,1,0,10306,IMP,GL,MATCH,1,2.02
Biscoit1n,129,10,16,1,-6,137.6,21,0,5,-5,10306,IMP,GL,MATCH,1,2.02
gustt1nha,125,7,19,6,-12,85.0,29,1,4,-3,10306,IMP,GL,MATCH,1,2.02
Evilkyk,200,30,33,8,-3,128.5,25,4,7,-3,10307,IMP,S5,MATCH,2,2.02
Biscoit1n,198,32,35,7,-3,130.4,30,5,9,-4,10307,IMP,S5,MATCH,2,2.02
tuyz,189,30,32,4,-2,122.2,15,2,3,-1,10307,IMP,S5,MATCH,2,2.02
rst,173,23,32,11,-9,116.5,22,4,3,1,10307,IMP,S5,MATCH,2,2.02
gustt1nha,95,15,31,8,-16,66.5,27,0,8,-8,10307,IMP,S5,MATCH,2,2.02
prozin,287,46,25,8,21,177.6,19,7,3,4,10307,S5,IMP,MATCH,2,2.02
fra,217,34,23,6,11,141.6,22,2,2,0,10307,S5,IMP,MATCH,2,2.02
gaabxx,204,32,30,5,2,132.7,24,13,8,5,10307,S5,IMP,MATCH,2,2.02
light,182,28,29,12,-1,139.3,24,6,1,5,10307,S5,IMP,MATCH,2,2.02
deNaro,158,23,23,15,0,107.0,23,2,1,1,10307,S5,IMP,MATCH,2,2.02
gustt1nha,233,19,14,3,5,149.1,22,5,4,1,10339,IMP,Rise,MATCH,1,2.02
rst,217,17,15,4,2,127.1,13,0,1,-1,10339,IMP,Rise,MATCH,1,2.02
tuyz,202,13,17,5,-4,141.1,28,2,2,0,10339,IMP,Rise,MATCH,1,2.02
Biscoit1n,176,14,17,3,-3,116.3,27,3,2,1,10339,IMP,Rise,MATCH,1,2.02
Evilkyk,153,10,17,6,-7,95.6,31,0,3,-3,10339,IMP,Rise,MATCH,1,2.02
glym,259,20,14,5,6,183.2,7,7,0,7,10339,Rise,IMP,MATCH,1,2.02
leonzhet,223,17,15,2,2,141.9,35,3,4,-1,10339,Rise,IMP,MATCH,1,2.02
Slag,213,18,14,2,4,141.2,29,0,1,-1,10339,Rise,IMP,MATCH,1,2.02
DmL,208,15,15,11,0,194.8,22,2,3,-1,10339,Rise,IMP,MATCH,1,2.02
GuhRVN,136,10,15,7,-5,131.1,27,0,2,-2,10339,Rise,IMP,MATCH,1,2.02
tuyz,200,22,32,7,-10,125.3,20,4,3,1,10345,IMP,FURI,MATCH,2,2.02
Biscoit1n,178,23,33,6,-10,108.1,24,6,10,-4,10345,IMP,FURI,MATCH,2,2.02
rst,170,23,30,4,-7,112.2,18,1,6,-5,10345,IMP,FURI,MATCH,2,2.02
gustt1nha,159,19,31,6,-12,98.1,27,1,3,-2,10345,IMP,FURI,MATCH,2,2.02
Evilkyk,122,15,34,10,-19,87.7,27,1,2,-1,10345,IMP,FURI,MATCH,2,2.02
qck,289,39,24,5,15,210.4,21,5,2,3,10345,FURI,IMP,MATCH,2,2.02
xand,280,38,24,4,14,139.1,18,9,6,3,10345,FURI,IMP,MATCH,2,2.02
Nozwerr,243,31,17,14,14,161.1,21,1,0,1,10345,FURI,IMP,MATCH,2,2.02
Khalil,209,30,18,9,12,135.4,21,5,3,2,10345,FURI,IMP,MATCH,2,2.02
txddy,184,22,19,16,3,112.2,22,4,2,2,10345,FURI,IMP,MATCH,2,2.02
Evilkyk,278,21,14,6,7,152.8,29,3,1,2,12072,IMP,FREE,MATCH,1,2.03
rst,239,17,14,8,3,142.5,14,0,1,-1,12072,IMP,FREE,MATCH,1,2.03
Biscoit1n,237,18,14,5,4,151.1,25,2,2,0,12072,IMP,FREE,MATCH,1,2.03
gustt1nha,235,17,13,5,4,173.2,30,2,4,-2,12072,IMP,FREE,MATCH,1,2.03
tuyz,155,11,13,5,-2,115.6,33,4,2,2,12072,IMP,FREE,MATCH,1,2.03
vhz,269,20,13,4,7,170.9,25,2,0,2,12072,FREE,IMP,MATCH,1,2.03
rood,213,13,19,6,-6,130.2,14,4,3,1,12072,FREE,IMP,MATCH,1,2.03
NikkoLAN,188,15,20,1,-5,107.6,30,2,2,0,12072,FREE,IMP,MATCH,1,2.03
FLG1,140,11,14,7,-3,87.0,29,2,3,-1,12072,FREE,IMP,MATCH,1,2.03
Fatal,136,9,18,6,-9,80.7,13,0,3,-3,12072,FREE,IMP,MATCH,1,2.03
Evilkyk,283,40,22,16,18,150.7,22,3,2,1,12078,IMP,Rise,MATCH,2,2.03
Biscoit1n,232,30,28,13,2,138.4,17,8,4,4,12078,IMP,Rise,MATCH,2,2.03
gustt1nha,231,33,26,17,7,148.7,19,2,7,-5,12078,IMP,Rise,MATCH,2,2.03
tuyz,172,21,21,17,0,99.7,19,2,2,0,12078,IMP,Rise,MATCH,2,2.03
rst,168,24,22,7,2,100.0,14,5,3,2,12078,IMP,Rise,MATCH,2,2.03
glym,238,31,29,6,2,155.1,18,6,2,4,12078,Rise,IMP,MATCH,2,2.03
Slag,215,28,32,8,-4,142.5,16,6,7,-1,12078,Rise,IMP,MATCH,2,2.03
leonzhet,179,21,31,18,-10,94.2,8,2,5,-3,12078,Rise,IMP,MATCH,2,2.03
GuhRVN,175,21,28,16,-7,139.1,25,1,1,0,12078,Rise,IMP,MATCH,2,2.03
DmL,142,18,28,7,-10,86.9,14,3,5,-2,12078,Rise,IMP,MATCH,2,2.03
