Player,ACS,K,D,A,KD_DIFF,ADR,HS%,FK,FD,FK_FD_DIFF,match_id,Team,Opp_Team,Map,Num_maps,Patch
BRNWOWZK1,249,56,44,8,12,144.9,19,7,8,-1,5279,DLWZK,HAVAN,MATCH,3,1.12
pavel,201,41,50,15,-9,123.2,13,5,9,-4,5279,DLWZK,HAVAN,MATCH,3,1.12
DmL,169,40,50,11,-10,101.7,20,7,5,2,5279,DLWZK,HAVAN,MATCH,3,1.12
zam,156,31,48,17,-17,106.0,13,5,5,0,5279,DLWZK,HAVAN,MATCH,3,1.12
fluyr,140,27,51,20,-24,100.2,18,4,7,-3,5279,DLWZK,HAVAN,MATCH,3,1.12
shion,299,68,32,25,36,196.3,23,8,1,7,5279,HAVAN,DLWZK,MATCH,3,1.12
pMdr1,259,54,38,13,16,149.5,33,7,8,-1,5279,HAVAN,DLWZK,MATCH,3,1.12
Myssen,192,47,40,16,7,119.9,41,4,8,-4,5279,HAVAN,DLWZK,MATCH,3,1.12
pleets,189,38,42,18,-4,109.6,14,6,4,2,5279,HAVAN,DLWZK,MATCH,3,1.12
bNhardneja,173,35,43,13,-8,111.3,13,9,7,2,5279,HAVAN,DLWZK,MATCH,3,1.12
pMdr1,312,41,17,6,24,228.5,29,6,2,4,5264,HAVAN,DKS,MATCH,2,1.12
shion,305,41,17,11,24,212.3,23,3,2,1,5264,HAVAN,DKS,MATCH,2,1.12
pleets,261,36,18,15,18,137.0,19,8,4,4,5264,HAVAN,DKS,MATCH,2,1.12
bNhardneja,193,21,19,14,2,120.6,16,4,2,2,5264,HAVAN,DKS,MATCH,2,1.12
Myssen,156,17,20,20,-3,96.2,20,2,2,0,5264,HAVAN,DKS,MATCH,2,1.12
Lupi,243,28,31,7,-3,151.9,29,5,8,-3,5264,DKS,HAVAN,MATCH,2,1.12
shawk,174,20,30,9,-10,134.8,18,3,6,-3,5264,DKS,HAVAN,MATCH,2,1.12
mat,144,15,33,11,-18,91.5,12,1,4,-3,5264,DKS,HAVAN,MATCH,2,1.12
taek,135,16,32,6,-16,79.6,14,3,3,0,5264,DKS,HAVAN,MATCH,2,1.12
gTTO,124,12,30,8,-18,86.1,23,0,2,-2,5264,DKS,HAVAN,MATCH,2,1.12
pMdr1,235,34,33,5,1,144.5,27,8,6,2,6686,HAVAN,paiN,MATCH,2,1.12
bNhardneja,214,31,29,11,2,153.9,21,2,6,-4,6686,HAVAN,paiN,MATCH,2,1.12
shion,199,24,29,17,-5,125.0,25,3,1,2,6686,HAVAN,paiN,MATCH,2,1.12
pleets,194,24,34,11,-10,106.5,12,4,7,-3,6686,HAVAN,paiN,MATCH,2,1.12
Myssen,145,25,26,1,-1,91.9,43,0,3,-3,6686,HAVAN,paiN,MATCH,2,1.12
kon4n,279,38,28,19,10,173.4,30,6,3,3,6686,paiN,HAVAN,MATCH,2,1.12
Txozin,233,31,30,11,1,113.1,20,3,2,1,6686,paiN,HAVAN,MATCH,2,1.12
Veroneze,227,31,24,10,7,141.3,31,8,2,6,6686,paiN,HAVAN,MATCH,2,1.12
murizzz,216,33,27,15,6,132.7,18,2,5,-3,6686,paiN,HAVAN,MATCH,2,1.12
matheuzin,126,18,29,5,-11,82.5,29,4,5,-1,6686,paiN,HAVAN,MATCH,2,1.12
NikkoLAN,274,44,31,8,13,159.4,23,11,9,2,4944,Vivo,HAVAN,MATCH,2,1.1
FLG1,202,32,31,12,1,133.1,22,6,2,4,4944,Vivo,HAVAN,MATCH,2,1.1
flainzz,200,33,30,9,3,122.8,24,3,3,0,4944,Vivo,HAVAN,MATCH,2,1.1
patochovsk,198,30,30,12,0,140.2,17,5,3,2,4944,Vivo,HAVAN,MATCH,2,1.1
NANZIN,136,23,33,12,-10,94.4,39,1,3,-2,4944,Vivo,HAVAN,MATCH,2,1.1
shion,285,42,30,17,12,192.2,32,3,2,1,4944,HAVAN,Vivo,MATCH,2,1.1
pMdr1,208,34,34,4,0,139.7,39,7,4,3,4944,HAVAN,Vivo,MATCH,2,1.1
Myssen,166,29,32,10,-3,109.0,45,2,8,-6,4944,HAVAN,Vivo,MATCH,2,1.1
bNhardneja,159,25,36,5,-11,105.9,26,5,8,-3,4944,HAVAN,Vivo,MATCH,2,1.1
pleets,154,25,30,9,-5,105.3,17,3,4,-1,4944,HAVAN,Vivo,MATCH,2,1.1
sant,225,14,17,6,-3,136.2,25,5,3,2,4902,eRa,HAVAN,MATCH,1,1.1
boltiNxd,225,15,14,3,1,136.0,15,2,1,1,4902,eRa,HAVAN,MATCH,1,1.1
Magic,190,11,17,5,-6,127.2,16,4,2,2,4902,eRa,HAVAN,MATCH,1,1.1
bUURST,189,14,15,1,-1,119.2,28,2,0,2,4902,eRa,HAVAN,MATCH,1,1.1
Sasaki,147,11,15,3,-4,83.8,13,0,0,0,4902,eRa,HAVAN,MATCH,1,1.1
shion,290,20,13,6,7,148.3,32,2,0,2,4902,HAVAN,eRa,MATCH,1,1.1
pleets,283,17,15,9,2,180.1,14,1,3,-2,4902,HAVAN,eRa,MATCH,1,1.1
pMdr1,221,15,13,5,2,146.6,29,1,5,-4,4902,HAVAN,eRa,MATCH,1,1.1
bNhardneja,210,15,11,3,4,137.8,24,2,2,0,4902,HAVAN,eRa,MATCH,1,1.1
Myssen,164,11,13,2,-2,106.7,42,0,3,-3,4902,HAVAN,eRa,MATCH,1,1.1
pMdr1,306,21,6,5,15,163.0,55,5,0,5,4901,HAVAN,Furn,MATCH,1,1.1
shion,282,18,6,5,12,165.1,63,4,0,4,4901,HAVAN,Furn,MATCH,1,1.1
bNhardneja,279,17,12,5,5,162.3,9,5,0,5,4901,HAVAN,Furn,MATCH,1,1.1
pleets,151,10,8,4,2,79.2,5,1,0,1,4901,HAVAN,Furn,MATCH,1,1.1
Myssen,142,8,9,9,-1,95.8,23,1,1,0,4901,HAVAN,Furn,MATCH,1,1.1
p9dro,276,16,14,4,2,165.2,31,0,1,-1,4901,Furn,HAVAN,MATCH,1,1.1
pit,161,9,15,4,-6,95.3,16,0,3,-3,4901,Furn,HAVAN,MATCH,1,1.1
Physicx,151,8,13,4,-5,101.1,30,0,2,-2,4901,Furn,HAVAN,MATCH,1,1.1
Vai,107,6,16,1,-10,70.1,29,1,3,-2,4901,Furn,HAVAN,MATCH,1,1.1
Fedrigues,80,2,16,5,-14,66.7,22,0,7,-7,4901,Furn,HAVAN,MATCH,1,1.1
New,172,8,14,0,-6,110.8,15,0,2,-2,4898,A-fo,HAVAN,MATCH,1,1.1
ãGBã,119,5,14,1,-9,73.9,24,1,3,-2,4898,A-fo,HAVAN,MATCH,1,1.1
WendyJr,103,3,14,3,-11,58.4,8,0,2,-2,4898,A-fo,HAVAN,MATCH,1,1.1
iSaeky,74,3,14,1,-11,43.3,5,0,4,-4,4898,A-fo,HAVAN,MATCH,1,1.1
Asuna,54,3,13,1,-10,37.1,31,0,2,-2,4898,A-fo,HAVAN,MATCH,1,1.1
pMdr1,350,18,4,5,14,210.9,31,6,1,5,4898,HAVAN,A-fo,MATCH,1,1.1
bNhardneja,324,15,7,10,8,221.4,18,2,0,2,4898,HAVAN,A-fo,MATCH,1,1.1
Myssen,312,18,2,2,16,191.9,61,1,0,1,4898,HAVAN,A-fo,MATCH,1,1.1
pleets,300,15,7,7,8,166.0,16,4,0,4,4898,HAVAN,A-fo,MATCH,1,1.1
shion,57,3,2,10,1,34.5,33,0,0,0,4898,HAVAN,A-fo,MATCH,1,1.1
shion,286,18,15,12,3,197.5,26,1,3,-2,4437,HAVAN,eRa,MATCH,1,1.1
Myssen,220,16,14,6,2,148.7,30,1,0,1,4437,HAVAN,eRa,MATCH,1,1.1
pMdr1,207,15,18,4,-3,144.2,33,4,3,1,4437,HAVAN,eRa,MATCH,1,1.1
bNhardneja,192,11,14,7,-3,135.4,9,1,4,-3,4437,HAVAN,eRa,MATCH,1,1.1
pleets,146,11,15,2,-4,106.1,28,2,1,1,4437,HAVAN,eRa,MATCH,1,1.1
Magic,312,24,13,5,11,180.6,17,5,2,3,4437,eRa,HAVAN,MATCH,1,1.1
boltiNxd,229,17,16,7,1,141.3,21,0,2,-2,4437,eRa,HAVAN,MATCH,1,1.1
Sasaki,193,15,14,5,1,123.8,21,0,0,0,4437,eRa,HAVAN,MATCH,1,1.1
bUURST,180,12,12,11,0,122.6,24,1,2,-1,4437,eRa,HAVAN,MATCH,1,1.1
sant,164,8,16,10,-8,102.6,33,5,3,2,4437,eRa,HAVAN,MATCH,1,1.1
pit,198,11,13,5,-2,119.0,28,0,2,-2,4436,Furn,HAVAN,MATCH,1,1.1
Physicx,196,9,14,5,-5,133.3,19,1,1,0,4436,Furn,HAVAN,MATCH,1,1.1
p9dro,149,8,15,0,-7,95.8,23,0,4,-4,4436,Furn,HAVAN,MATCH,1,1.1
Fedrigues,110,5,16,2,-11,63.9,8,0,5,-5,4436,Furn,HAVAN,MATCH,1,1.1
Vai,101,5,16,1,-11,72.4,11,1,2,-1,4436,Furn,HAVAN,MATCH,1,1.1
pleets,328,20,8,10,12,223.4,18,4,0,4,4436,HAVAN,Furn,MATCH,1,1.1
pMdr1,301,18,8,1,10,181.8,43,3,0,3,4436,HAVAN,Furn,MATCH,1,1.1
bNhardneja,236,13,9,4,4,126.9,20,3,0,3,4436,HAVAN,Furn,MATCH,1,1.1
shion,209,13,5,10,8,126.4,28,2,2,0,4436,HAVAN,Furn,MATCH,1,1.1
Myssen,145,10,8,2,2,99.0,35,2,0,2,4436,HAVAN,Furn,MATCH,1,1.1
bNhardneja,447,23,5,5,18,266.4,15,5,0,5,4433,HAVAN,A-fo,MATCH,1,1.1
pMdr1,338,17,6,2,11,198.5,27,3,0,3,4433,HAVAN,A-fo,MATCH,1,1.1
Myssen,225,12,3,3,9,118.2,48,0,1,-1,4433,HAVAN,A-fo,MATCH,1,1.1
shion,168,9,3,7,6,118.9,30,3,1,2,4433,HAVAN,A-fo,MATCH,1,1.1
pleets,139,7,4,4,3,104.7,12,1,0,1,4433,HAVAN,A-fo,MATCH,1,1.1
New,181,8,13,1,-5,129.9,9,0,2,-2,4433,A-fo,HAVAN,MATCH,1,1.1
iLadyTRz,136,6,13,1,-7,73.5,16,0,2,-2,4433,A-fo,HAVAN,MATCH,1,1.1
TioK1ll3R,96,3,14,3,-11,65.9,4,1,2,-1,4433,A-fo,HAVAN,MATCH,1,1.1
WendyJr,58,3,14,1,-11,34.6,13,1,2,-1,4433,A-fo,HAVAN,MATCH,1,1.1
iSaeky,12,0,14,1,-14,12.6,0,0,4,-4,4433,A-fo,HAVAN,MATCH,1,1.1
delevingne,384,21,9,2,12,224.6,30,5,2,3,3063,FF,HAVAN,MATCH,1,1.08
fzkk,254,12,10,5,2,156.9,13,2,2,0,3063,FF,HAVAN,MATCH,1,1.08
dragonite,244,14,4,7,10,151.9,26,1,0,1,3063,FF,HAVAN,MATCH,1,1.08
krain,236,11,6,8,5,150.8,15,0,1,-1,3063,FF,HAVAN,MATCH,1,1.08
v1xen,108,8,6,4,2,47.4,18,1,0,1,3063,FF,HAVAN,MATCH,1,1.08
pMdr1,243,10,14,1,-4,159.9,42,2,3,-1,3063,HAVAN,FF,MATCH,1,1.08
Myssen,175,8,13,0,-5,117.5,48,1,4,-3,3063,HAVAN,FF,MATCH,1,1.08
shion,163,7,14,3,-7,101.6,30,1,0,1,3063,HAVAN,FF,MATCH,1,1.08
pleets,110,6,13,3,-7,65.9,14,1,1,0,3063,HAVAN,FF,MATCH,1,1.08
bNhardneja,97,4,12,1,-8,58.0,31,0,1,-1,3063,HAVAN,FF,MATCH,1,1.08
gtnziN,264,20,16,2,4,146.4,20,2,5,-3,3059,VKS,HAVAN,MATCH,1,1.08
fuzari,200,16,16,1,0,131.7,27,2,2,0,3059,VKS,HAVAN,MATCH,1,1.08
deNaro,153,11,17,7,-6,103.1,13,1,3,-2,3059,VKS,HAVAN,MATCH,1,1.08
BrinkssJ,150,8,19,11,-11,107.6,19,4,2,2,3059,VKS,HAVAN,MATCH,1,1.08
cad,102,9,15,0,-6,112.2,17,0,1,-1,3059,VKS,HAVAN,MATCH,1,1.08
shion,252,21,13,8,8,183.5,21,4,2,2,3059,HAVAN,VKS,MATCH,1,1.08
pleets,222,16,13,6,3,147.3,22,2,2,0,3059,HAVAN,VKS,MATCH,1,1.08
Myssen,201,14,15,7,-1,128.2,36,2,2,0,3059,HAVAN,VKS,MATCH,1,1.08
bNhardneja,198,15,13,3,2,132.9,18,3,0,3,3059,HAVAN,VKS,MATCH,1,1.08
pMdr1,194,16,11,6,5,103.3,37,2,3,-1,3059,HAVAN,VKS,MATCH,1,1.08
pleets,258,20,15,6,5,161.5,13,6,0,6,3055,HAVAN,Come,MATCH,1,1.08
shion,216,19,12,6,7,126.7,24,3,0,3,3055,HAVAN,Come,MATCH,1,1.08
bNhardneja,207,15,14,8,1,129.7,13,3,2,1,3055,HAVAN,Come,MATCH,1,1.08
Myssen,195,14,15,5,-1,126.4,45,3,2,1,3055,HAVAN,Come,MATCH,1,1.08
pMdr1,145,12,17,4,-5,136.0,30,2,2,0,3055,HAVAN,Come,MATCH,1,1.08
dabliuZNEY,232,18,19,4,-1,141.1,11,1,5,-4,3055,Come,HAVAN,MATCH,1,1.08
PxL,205,15,17,8,-2,127.0,15,2,5,-3,3055,Come,HAVAN,MATCH,1,1.08
PROGRAMMER,178,15,16,6,-1,126.4,24,2,2,0,3055,Come,HAVAN,MATCH,1,1.08
why,153,11,17,4,-6,95.0,17,0,2,-2,3055,Come,HAVAN,MATCH,1,1.08
BladeZ,143,13,11,1,2,82.1,25,1,3,-2,3055,Come,HAVAN,MATCH,1,1.08
NikkoLAN,243,52,40,11,12,157.9,22,10,5,5,6631,Vivo,HAVAN,MATCH,2,1.12
patochovsk,233,46,39,17,7,144.1,11,7,5,2,6631,Vivo,HAVAN,MATCH,2,1.12
FLG1,193,40,44,14,-4,135.3,20,7,5,2,6631,Vivo,HAVAN,MATCH,2,1.12
NANZIN,164,34,39,14,-5,98.3,32,7,7,0,6631,Vivo,HAVAN,MATCH,2,1.12
flainzz,156,29,40,9,-11,103.1,10,3,4,-1,6631,Vivo,HAVAN,MATCH,2,1.12
shion,245,50,34,25,16,155.5,19,5,4,1,6631,HAVAN,Vivo,MATCH,2,1.12
pMdr1,224,47,48,9,-1,133.7,28,8,10,-2,6631,HAVAN,Vivo,MATCH,2,1.12
Myssen,192,42,37,10,5,143.2,36,1,3,-2,6631,HAVAN,Vivo,MATCH,2,1.12
pleets,164,36,38,17,-2,100.8,20,4,8,-4,6631,HAVAN,Vivo,MATCH,2,1.12
bNhardneja,159,27,44,14,-17,119.6,9,8,9,-1,6631,HAVAN,Vivo,MATCH,2,1.12
shion,296,40,18,26,22,172.1,25,3,2,1,6629,HAVAN,tiob,MATCH,2,1.12
pleets,284,39,21,16,18,198.6,16,8,0,8,6629,HAVAN,tiob,MATCH,2,1.12
pMdr1,207,29,25,6,4,126.8,26,7,6,1,6629,HAVAN,tiob,MATCH,2,1.12
bNhardneja,181,26,24,8,2,156.4,26,3,2,1,6629,HAVAN,tiob,MATCH,2,1.12
Myssen,135,17,21,11,-4,82.2,25,2,5,-3,6629,HAVAN,tiob,MATCH,2,1.12
Hastad,217,22,31,14,-9,148.1,9,4,9,-5,6629,tiob,HAVAN,MATCH,2,1.12
NandeX,196,24,27,13,-3,149.4,12,3,2,1,6629,tiob,HAVAN,MATCH,2,1.12
dtt1,190,26,30,4,-4,105.6,18,2,4,-2,6629,tiob,HAVAN,MATCH,2,1.12
Rub1ka,187,26,32,6,-6,121.1,25,5,6,-1,6629,tiob,HAVAN,MATCH,2,1.12
Igaum,85,11,31,4,-20,63.1,22,1,2,-1,6629,tiob,HAVAN,MATCH,2,1.12
shion,200,36,19,14,17,123.6,35,2,0,2,6002,HAVAN,HAVAN,MATCH,1,1.12
pMdr1,178,41,26,6,15,91.7,19,5,3,2,6002,HAVAN,HAVAN,MATCH,1,1.12
pleets,173,31,23,15,8,92.6,9,3,2,1,6002,HAVAN,HAVAN,MATCH,1,1.12
Myssen,124,31,22,9,9,75.1,46,3,1,2,6002,HAVAN,HAVAN,MATCH,1,1.12
bNhardneja,97,22,23,10,-1,62.7,15,1,3,-2,6002,HAVAN,HAVAN,MATCH,1,1.12
shion,316,21,10,7,11,198.5,33,2,0,2,6002,HAVAN,HAVAN,MATCH,1,1.12
pMdr1,306,21,11,1,10,156.8,17,4,2,2,6002,HAVAN,HAVAN,MATCH,1,1.12
pleets,278,17,9,7,8,172.6,11,3,2,1,6002,HAVAN,HAVAN,MATCH,1,1.12
Myssen,171,11,12,4,-1,103.2,38,2,0,2,6002,HAVAN,HAVAN,MATCH,1,1.12
bNhardneja,141,9,11,8,-2,107.4,14,0,3,-3,6002,HAVAN,HAVAN,MATCH,1,1.12
Zap,255,23,17,0,6,141.2,14,3,1,2,5997,oNe,HAVAN,MATCH,1,1.12
ntk,228,18,17,9,1,136.3,22,3,2,1,5997,oNe,HAVAN,MATCH,1,1.12
Cpx,209,17,20,7,-3,121.8,30,1,4,-3,5997,oNe,HAVAN,MATCH,1,1.12
Maverick,189,15,19,5,-4,137.3,35,4,4,0,5997,oNe,HAVAN,MATCH,1,1.12
Champzera,161,15,18,4,-3,108.2,22,1,1,0,5997,oNe,HAVAN,MATCH,1,1.12
pleets,270,23,17,5,6,165.3,16,4,2,2,5997,HAVAN,oNe,MATCH,1,1.12
shion,251,21,17,9,4,157.5,20,1,0,1,5997,HAVAN,oNe,MATCH,1,1.12
pMdr1,247,20,17,7,3,147.7,24,2,4,-2,5997,HAVAN,oNe,MATCH,1,1.12
Myssen,159,14,18,4,-4,106.6,39,1,1,0,5997,HAVAN,oNe,MATCH,1,1.12
bNhardneja,154,13,19,1,-6,104.7,32,4,5,-1,5997,HAVAN,oNe,MATCH,1,1.12
shion,331,30,17,12,13,208.4,27,2,2,0,5996,HAVAN,VKS,MATCH,1,1.12
pleets,226,24,22,10,2,120.7,13,2,1,1,5996,HAVAN,VKS,MATCH,1,1.12
pMdr1,200,18,23,9,-5,118.4,22,4,6,-2,5996,HAVAN,VKS,MATCH,1,1.12
Myssen,174,18,19,2,-1,101.4,61,3,5,-2,5996,HAVAN,VKS,MATCH,1,1.12
bNhardneja,168,14,19,8,-5,111.4,14,2,1,1,5996,HAVAN,VKS,MATCH,1,1.12
fuzari,285,30,21,6,9,188.6,30,3,1,2,5996,VKS,HAVAN,MATCH,1,1.12
gtnziN,232,23,22,1,1,155.5,21,5,2,3,5996,VKS,HAVAN,MATCH,1,1.12
deNaro,194,16,19,9,-3,131.3,22,3,3,0,5996,VKS,HAVAN,MATCH,1,1.12
BrinkssJ,177,15,20,8,-5,127.6,20,2,2,0,5996,VKS,HAVAN,MATCH,1,1.12
cad,153,16,22,1,-6,105.1,13,2,5,-3,5996,VKS,HAVAN,MATCH,1,1.12
gtnziN,301,32,15,5,17,176.8,26,1,2,-1,2705,VKS,HAVAN,MATCH,1,1.07
fuzari,219,21,18,6,3,149.8,26,3,5,-2,2705,VKS,HAVAN,MATCH,1,1.07
cad,191,18,18,2,0,116.1,17,2,5,-3,2705,VKS,HAVAN,MATCH,1,1.07
deNaro,183,15,20,14,-5,133.0,22,4,1,3,2705,VKS,HAVAN,MATCH,1,1.07
BrinkssJ,128,11,19,6,-8,82.4,33,2,3,-1,2705,VKS,HAVAN,MATCH,1,1.07
pMdr1,265,24,23,8,1,169.8,20,6,5,1,2705,HAVAN,VKS,MATCH,1,1.07
bNhardneja,240,24,17,3,7,134.2,14,7,0,7,2705,HAVAN,VKS,MATCH,1,1.07
pleets,174,17,22,4,-5,108.8,13,1,2,-1,2705,HAVAN,VKS,MATCH,1,1.07
Myssen,147,16,16,10,0,97.7,34,2,5,-3,2705,HAVAN,VKS,MATCH,1,1.07
shion,118,9,19,10,-10,86.7,19,0,0,0,2705,HAVAN,VKS,MATCH,1,1.07
surpriiseeee,257,19,12,0,7,151.1,22,4,1,3,2715,Onfi,HAVAN,MATCH,1,1.07
tockers,192,13,9,13,4,125.9,21,3,1,2,2715,Onfi,HAVAN,MATCH,1,1.07
AimGreen,183,15,11,4,4,122.2,27,0,2,-2,2715,Onfi,HAVAN,MATCH,1,1.07
phz,164,8,13,9,-5,117.8,20,4,3,1,2715,Onfi,HAVAN,MATCH,1,1.07
Clovis,137,11,12,3,-1,86.2,24,1,1,0,2715,Onfi,HAVAN,MATCH,1,1.07
pMdr1,260,15,17,4,-2,190.4,27,5,4,1,2715,HAVAN,Onfi,MATCH,1,1.07
Myssen,198,14,12,5,2,126.5,32,0,4,-4,2715,HAVAN,Onfi,MATCH,1,1.07
shion,184,11,11,4,0,110.6,23,1,1,0,2715,HAVAN,Onfi,MATCH,1,1.07
pleets,131,10,13,3,-3,86.7,23,1,1,0,2715,HAVAN,Onfi,MATCH,1,1.07
bNhardneja,111,7,13,3,-6,82.7,21,1,2,-1,2715,HAVAN,Onfi,MATCH,1,1.07
pMdr1,263,18,17,6,1,154.0,14,2,5,-3,2739,HAVAN,Zool,MATCH,1,1.07
shion,247,17,16,5,1,195.5,27,3,1,2,2739,HAVAN,Zool,MATCH,1,1.07
bNhardneja,198,13,15,4,-2,117.1,26,2,1,1,2739,HAVAN,Zool,MATCH,1,1.07
Myssen,158,11,17,3,-6,104.1,38,1,3,-2,2739,HAVAN,Zool,MATCH,1,1.07
pleets,151,11,15,3,-4,110.4,12,1,1,0,2739,HAVAN,Zool,MATCH,1,1.07
Tubarão,316,22,15,8,7,193.7,19,3,3,0,2739,Zool,HAVAN,MATCH,1,1.07
Canguru,225,15,12,4,3,151.4,24,3,1,2,2739,Zool,HAVAN,MATCH,1,1.07
Pavão,211,17,13,8,4,123.4,35,3,3,0,2739,Zool,HAVAN,MATCH,1,1.07
Peixe,199,16,15,2,1,99.5,17,2,0,2,2739,Zool,HAVAN,MATCH,1,1.07
Lobo,129,8,15,4,-7,93.0,5,0,2,-2,2739,Zool,HAVAN,MATCH,1,1.07
chase,280,70,41,10,29,180.0,34,10,3,7,2747,N2B,HAVAN,MATCH,3,1.06
bielthemagician,218,47,42,28,5,147.5,25,1,6,-5,2747,N2B,HAVAN,MATCH,3,1.06
gaabxx,213,50,38,12,12,122.5,11,8,5,3,2747,N2B,HAVAN,MATCH,3,1.06
Gabriel,167,36,48,10,-12,134.3,18,3,3,0,2747,N2B,HAVAN,MATCH,3,1.06
MATHR,142,31,49,16,-18,92.8,19,11,15,-4,2747,N2B,HAVAN,MATCH,3,1.06
bNhardneja,216,47,41,16,6,122.3,8,5,4,1,2747,HAVAN,N2B,MATCH,3,1.06
pMdr1,215,47,54,19,-7,143.1,27,11,5,6,2747,HAVAN,N2B,MATCH,3,1.06
shion,212,49,43,27,6,137.0,25,4,5,-1,2747,HAVAN,N2B,MATCH,3,1.06
Myssen,170,36,53,16,-17,109.4,38,7,11,-4,2747,HAVAN,N2B,MATCH,3,1.06
pleets,163,35,43,21,-8,96.3,13,5,8,-3,2747,HAVAN,N2B,MATCH,3,1.06
delevingne,346,24,15,4,9,169.6,18,9,5,4,2443,FF,HAVAN,MATCH,1,1.07
fzkk,265,17,9,10,8,179.0,20,2,1,1,2443,FF,HAVAN,MATCH,1,1.07
krain,210,15,9,6,6,149.0,36,1,0,1,2443,FF,HAVAN,MATCH,1,1.07
v1xen,113,9,9,3,0,79.2,41,1,1,0,2443,FF,HAVAN,MATCH,1,1.07
dragonite,74,6,8,5,-2,43.7,11,0,0,0,2443,FF,HAVAN,MATCH,1,1.07
pMdr1,181,13,15,2,-2,124.8,20,4,3,1,2443,HAVAN,FF,MATCH,1,1.07
shion,155,11,13,6,-2,118.8,41,1,2,-1,2443,HAVAN,FF,MATCH,1,1.07
bNhardneja,148,10,13,3,-3,101.6,12,1,2,-1,2443,HAVAN,FF,MATCH,1,1.07
pleets,143,9,17,3,-8,92.3,3,1,4,-3,2443,HAVAN,FF,MATCH,1,1.07
Myssen,109,7,13,3,-6,65.5,37,0,2,-2,2443,HAVAN,FF,MATCH,1,1.07
Hastad,251,20,19,4,1,160.5,10,2,4,-2,2453,tiob,HAVAN,MATCH,1,1.07
dtt1,214,17,20,5,-3,187.3,25,3,2,1,2453,tiob,HAVAN,MATCH,1,1.07
NandeX,194,15,17,10,-2,101.9,17,2,0,2,2453,tiob,HAVAN,MATCH,1,1.07
Rub1ka,133,12,16,6,-4,86.8,26,2,1,1,2453,tiob,HAVAN,MATCH,1,1.07
Igaum,120,9,18,7,-9,76.1,12,2,5,-3,2453,tiob,HAVAN,MATCH,1,1.07
shion,317,24,13,12,11,172.6,25,2,2,0,2453,HAVAN,tiob,MATCH,1,1.07
bNhardneja,286,25,14,2,11,165.8,15,2,2,0,2453,HAVAN,tiob,MATCH,1,1.07
pMdr1,260,19,16,10,3,159.7,31,5,2,3,2453,HAVAN,tiob,MATCH,1,1.07
Myssen,160,14,15,2,-1,148.0,52,1,1,0,2453,HAVAN,tiob,MATCH,1,1.07
pleets,74,7,16,4,-9,46.1,3,2,4,-2,2453,HAVAN,tiob,MATCH,1,1.07
delevingne,305,42,36,9,6,168.4,18,9,10,-1,2456,FF,HAVAN,MATCH,2,1.07
fzkk,223,29,30,10,-1,145.0,14,7,2,5,2456,FF,HAVAN,MATCH,2,1.07
v1xen,215,34,21,15,13,125.8,25,3,3,0,2456,FF,HAVAN,MATCH,2,1.07
krain,206,35,20,9,15,141.6,16,1,1,0,2456,FF,HAVAN,MATCH,2,1.07
dragonite,157,25,24,10,1,100.9,22,4,2,2,2456,FF,HAVAN,MATCH,2,1.07
bNhardneja,219,31,33,8,-2,134.5,16,7,3,4,2456,HAVAN,FF,MATCH,2,1.07
pMdr1,175,24,35,9,-11,108.0,23,6,9,-3,2456,HAVAN,FF,MATCH,2,1.07
Myssen,170,27,30,3,-3,114.7,44,1,2,-1,2456,HAVAN,FF,MATCH,2,1.07
pleets,162,26,33,7,-7,92.6,11,3,4,-1,2456,HAVAN,FF,MATCH,2,1.07
shion,160,23,34,16,-11,99.8,21,1,6,-5,2456,HAVAN,FF,MATCH,2,1.07
pMdr1,384,30,18,3,12,211.1,40,7,6,1,8228,HAVAN,dogz,MATCH,1,1.14
shion,257,17,16,9,1,177.0,16,1,0,1,8228,HAVAN,dogz,MATCH,1,1.14
felipinho,200,17,15,9,2,113.1,27,0,2,-2,8228,HAVAN,dogz,MATCH,1,1.14
Myssen,158,13,12,10,1,107.8,37,0,2,-2,8228,HAVAN,dogz,MATCH,1,1.14
bNhardneja,133,8,15,12,-7,99.7,9,1,3,-2,8228,HAVAN,dogz,MATCH,1,1.14
toezin,272,23,16,3,7,160.6,22,1,2,-1,8228,dogz,HAVAN,MATCH,1,1.14
Cryy,214,17,14,4,3,125.7,14,6,1,5,8228,dogz,HAVAN,MATCH,1,1.14
Otsuka,192,14,18,6,-4,135.5,23,2,0,2,8228,dogz,HAVAN,MATCH,1,1.14
Less,173,13,19,2,-6,87.5,14,3,5,-2,8228,dogz,HAVAN,MATCH,1,1.14
PedroGOD,142,9,18,4,-9,96.0,13,1,1,0,8228,dogz,HAVAN,MATCH,1,1.14
shion,252,39,33,10,6,146.7,17,8,3,5,8242,HAVAN,ATHZ,MATCH,2,1.14
pleets,241,37,36,16,1,145.5,12,8,6,2,8242,HAVAN,ATHZ,MATCH,2,1.14
bNhardneja,207,32,30,12,2,127.9,15,2,1,1,8242,HAVAN,ATHZ,MATCH,2,1.14
pMdr1,157,26,37,8,-11,92.7,25,2,11,-9,8242,HAVAN,ATHZ,MATCH,2,1.14
Myssen,142,20,33,9,-13,86.5,24,2,3,-1,8242,HAVAN,ATHZ,MATCH,2,1.14
BladeZ,260,44,27,12,17,200.7,34,3,3,0,8242,ATHZ,HAVAN,MATCH,2,1.14
REPOW,254,36,33,18,3,163.0,22,4,3,1,8242,ATHZ,HAVAN,MATCH,2,1.14
kato,246,38,35,10,3,132.5,12,12,7,5,8242,ATHZ,HAVAN,MATCH,2,1.14
PxL,168,28,33,10,-5,124.8,15,3,4,-1,8242,ATHZ,HAVAN,MATCH,2,1.14
vtrg0d,140,23,26,8,-3,121.5,16,2,5,-3,8242,ATHZ,HAVAN,MATCH,2,1.14
shion,194,22,28,8,-6,111.0,27,1,1,0,9091,HAVAN,S5,MATCH,2,2.01
Myssen,173,21,29,6,-8,116.9,36,0,2,-2,9091,HAVAN,S5,MATCH,2,2.01
pleets,147,13,28,9,-15,100.7,10,4,3,1,9091,HAVAN,S5,MATCH,2,2.01
felipinho,140,14,28,9,-14,93.0,19,7,8,-1,9091,HAVAN,S5,MATCH,2,2.01
pMdr1,103,11,30,2,-19,75.3,24,2,7,-5,9091,HAVAN,S5,MATCH,2,2.01
prozin,291,33,22,14,11,180.0,17,5,6,-1,9091,S5,HAVAN,MATCH,2,2.01
gaabxx,285,38,16,4,22,163.3,24,8,2,6,9091,S5,HAVAN,MATCH,2,2.01
deNaro,222,27,14,16,13,134.3,25,3,0,3,9091,S5,HAVAN,MATCH,2,2.01
fooX,205,21,13,18,8,115.1,19,1,1,0,9091,S5,HAVAN,MATCH,2,2.01
fra,172,23,16,5,7,100.4,25,3,4,-1,9091,S5,HAVAN,MATCH,2,2.01
delevingne,316,43,19,18,24,157.2,10,2,4,-2,10295,Vora,HAVAN,MATCH,2,2.02
dragonite,259,34,22,6,12,140.7,16,8,8,0,10295,Vora,HAVAN,MATCH,2,2.02
fzkk,241,30,30,11,0,147.9,9,7,3,4,10295,Vora,HAVAN,MATCH,2,2.02
krain,212,33,16,11,17,144.8,30,1,1,0,10295,Vora,HAVAN,MATCH,2,2.02
v1xen,168,22,20,18,2,100.6,10,2,2,0,10295,Vora,HAVAN,MATCH,2,2.02
shion,241,31,34,7,-3,148.2,18,4,1,3,10295,HAVAN,Vora,MATCH,2,2.02
Myssen,186,29,30,3,-1,122.9,28,3,4,-1,10295,HAVAN,Vora,MATCH,2,2.02
pMdr1,141,17,32,4,-15,122.8,23,3,5,-2,10295,HAVAN,Vora,MATCH,2,2.02
pleets,135,16,33,15,-17,82.6,8,5,4,1,10295,HAVAN,Vora,MATCH,2,2.02
felipinho,126,14,34,8,-20,93.2,19,3,6,-3,10295,HAVAN,Vora,MATCH,2,2.02
murizzz,234,15,18,7,-3,152.8,28,6,3,3,10287,paiN,HAVAN,MATCH,1,2.02
kon4n,226,12,16,11,-4,141.9,12,1,0,1,10287,paiN,HAVAN,MATCH,1,2.02
matheuzin,202,13,14,5,-1,130.4,18,0,0,0,10287,paiN,HAVAN,MATCH,1,2.02
pepa,139,10,17,4,-7,129.1,12,2,1,1,10287,paiN,HAVAN,MATCH,1,2.02
ryotzz,136,8,19,2,-11,88.5,12,1,5,-4,10287,paiN,HAVAN,MATCH,1,2.02
shion,345,22,12,10,10,216.2,24,3,3,0,10287,HAVAN,paiN,MATCH,1,2.02
pMdr1,279,22,9,4,13,145.9,42,1,2,-1,10287,HAVAN,paiN,MATCH,1,2.02
felipinho,263,17,16,7,1,147.6,11,3,2,1,10287,HAVAN,paiN,MATCH,1,2.02
Myssen,198,13,10,8,3,194.3,23,1,0,1,10287,HAVAN,paiN,MATCH,1,2.02
pleets,144,10,11,8,-1,129.7,18,1,3,-2,10287,HAVAN,paiN,MATCH,1,2.02
felipinho,277,29,21,9,8,186.6,16,5,2,3,10309,HAVAN,Vora,MATCH,1,2.02
shion,234,21,22,15,-1,137.3,12,5,0,5,10309,HAVAN,Vora,MATCH,1,2.02
Myssen,201,22,23,10,-1,129.6,32,2,1,1,10309,HAVAN,Vora,MATCH,1,2.02
pMdr1,191,20,21,2,-1,108.4,24,6,8,-2,10309,HAVAN,Vora,MATCH,1,2.02
pleets,156,16,20,11,-4,98.7,16,0,1,-1,10309,HAVAN,Vora,MATCH,1,2.02
fzkk,336,34,21,4,13,221.9,9,5,5,0,10309,Vora,HAVAN,MATCH,1,2.02
delevingne,271,28,22,11,6,158.3,19,2,3,-1,10309,Vora,HAVAN,MATCH,1,2.02
dragonite,215,22,20,7,2,131.4,24,1,6,-5,10309,Vora,HAVAN,MATCH,1,2.02
krain,133,12,23,10,-11,87.9,28,3,2,1,10309,Vora,HAVAN,MATCH,1,2.02
v1xen,100,11,22,5,-11,63.9,15,1,2,-1,10309,Vora,HAVAN,MATCH,1,2.02
gaabxx,323,55,33,7,22,186.5,20,12,3,9,10320,S5,HAVAN,MATCH,2,2.02
prozin,272,42,32,10,10,163.3,22,8,3,5,10320,S5,HAVAN,MATCH,2,2.02
light,230,38,28,13,10,143.0,28,4,2,2,10320,S5,HAVAN,MATCH,2,2.02
deNaro,218,32,28,29,4,143.4,20,3,6,-3,10320,S5,HAVAN,MATCH,2,2.02
fra,108,16,32,18,-16,67.2,19,0,5,-5,10320,S5,HAVAN,MATCH,2,2.02
shion,310,46,33,18,13,175.4,17,3,1,2,10320,HAVAN,S5,MATCH,2,2.02
pMdr1,194,33,36,10,-3,110.2,14,3,7,-4,10320,HAVAN,S5,MATCH,2,2.02
felipinho,190,28,40,6,-12,116.8,23,9,5,4,10320,HAVAN,S5,MATCH,2,2.02
Myssen,176,30,36,7,-6,117.1,36,4,6,-2,10320,HAVAN,S5,MATCH,2,2.02
pleets,117,16,38,12,-22,75.0,14,0,8,-8,10320,HAVAN,S5,MATCH,2,2.02
