Player,ACS,K,D,A,KD_DIFF,ADR,HS%,FK,FD,FK_FD_DIFF,match_id,Team,Opp_Team,Map,Num_maps,Patch
heat,297,83,54,17,29,178.6,31,19,12,7,8611,DLWZK,Rise,MATCH,4,2.01
BRNWOWZK1,277,74,48,26,26,157.6,19,4,7,-3,8611,DLWZK,Rise,MATCH,4,2.01
rhamurti,202,54,46,32,8,148.6,20,6,1,5,8611,DLWZK,Rise,MATCH,4,2.01
fluyr,187,52,42,22,10,112.8,20,6,7,-1,8611,DLWZK,Rise,MATCH,4,2.01
zam,178,50,59,23,-9,112.8,19,6,10,-4,8611,DLWZK,Rise,MATCH,4,2.01
glym,266,71,63,18,8,163.3,17,13,5,8,8611,Rise,DLWZK,MATCH,4,2.01
Slag,182,49,67,21,-18,112.4,28,11,12,-1,8611,Rise,DLWZK,MATCH,4,2.01
leonzhet,182,46,60,14,-14,132.3,27,5,3,2,8611,Rise,DLWZK,MATCH,4,2.01
DmL,171,48,62,14,-14,124.7,19,7,12,-5,8611,Rise,DLWZK,MATCH,4,2.01
GuhRVN,144,35,61,21,-26,87.9,13,1,9,-8,8611,Rise,DLWZK,MATCH,4,2.01
glym,263,56,44,8,12,156.8,16,9,8,1,8610,Rise,ATHZ,MATCH,3,2.01
GuhRVN,249,56,40,13,16,150.0,23,8,2,6,8610,Rise,ATHZ,MATCH,3,2.01
leonzhet,192,43,38,18,5,129.1,25,1,7,-6,8610,Rise,ATHZ,MATCH,3,2.01
Slag,178,38,45,17,-7,110.1,22,6,8,-2,8610,Rise,ATHZ,MATCH,3,2.01
DmL,150,30,49,18,-19,100.3,22,6,9,-3,8610,Rise,ATHZ,MATCH,3,2.01
kato,229,49,42,17,7,141.7,15,7,2,5,8610,ATHZ,Rise,MATCH,3,2.01
vtrg0d,193,43,44,19,-1,123.4,17,4,7,-3,8610,ATHZ,Rise,MATCH,3,2.01
PxL,192,43,49,19,-6,115.6,22,7,11,-4,8610,ATHZ,Rise,MATCH,3,2.01
BladeZ,190,43,45,14,-2,109.2,31,7,6,1,8610,ATHZ,Rise,MATCH,3,2.01
REPOW,166,38,43,19,-5,102.2,23,9,4,5,8610,ATHZ,Rise,MATCH,3,2.01
GuhRVN,259,31,20,15,11,167.9,18,4,1,3,8607,Rise,aim,MATCH,2,
Slag,248,34,27,8,7,140.4,39,9,4,5,8607,Rise,aim,MATCH,2,
glym,235,30,24,7,6,129.9,13,6,2,4,8607,Rise,aim,MATCH,2,
leonzhet,226,28,19,21,9,122.1,25,1,3,-2,8607,Rise,aim,MATCH,2,
DmL,195,29,19,9,10,146.8,17,4,3,1,8607,Rise,aim,MATCH,2,
chase,285,32,32,8,0,169.2,21,5,6,-1,8607,aim,Rise,MATCH,2,
havoc,198,22,32,9,-10,109.7,14,4,6,-2,8607,aim,Rise,MATCH,2,
mtr,155,23,30,5,-7,110.7,30,0,5,-5,8607,aim,Rise,MATCH,2,
cqJESUS,144,19,28,7,-9,83.9,20,3,3,0,8607,aim,Rise,MATCH,2,
bielthemagician,110,13,30,9,-17,74.5,33,1,4,-3,8607,aim,Rise,MATCH,2,
pavel,232,40,45,16,-5,154.9,12,3,5,-2,10294,RED,Rise,MATCH,2,2.02
vhz,226,42,42,8,0,165.4,27,9,9,0,10294,RED,Rise,MATCH,2,2.02
KHTEX,193,37,41,11,-4,137.5,28,4,7,-3,10294,RED,Rise,MATCH,2,2.02
FLG1,192,34,41,11,-7,109.5,31,4,7,-3,10294,RED,Rise,MATCH,2,2.02
Fatal,163,31,38,12,-7,103.0,32,1,5,-4,10294,RED,Rise,MATCH,2,2.02
glym,304,58,35,9,23,194.2,13,10,5,5,10294,Rise,RED,MATCH,2,2.02
DmL,230,44,38,10,6,136.9,27,9,4,5,10294,Rise,RED,MATCH,2,2.02
GuhRVN,202,41,34,15,7,146.9,22,6,2,4,10294,Rise,RED,MATCH,2,2.02
Slag,191,37,40,16,-3,101.6,19,3,5,-2,10294,Rise,RED,MATCH,2,2.02
leonzhet,175,27,37,20,-10,124.2,22,5,5,0,10294,Rise,RED,MATCH,2,2.02
Magic,273,57,51,14,6,186.2,16,9,6,3,10266,JAG,Rise,MATCH,3,2.02
sant,193,39,46,14,-7,145.0,22,5,12,-7,10266,JAG,Rise,MATCH,3,2.02
boltiNxd,184,38,44,23,-6,130.1,22,4,6,-2,10266,JAG,Rise,MATCH,3,2.02
AimGreen,179,38,46,15,-8,131.2,21,5,6,-1,10266,JAG,Rise,MATCH,3,2.02
napz,161,34,44,13,-10,116.5,22,2,5,-3,10266,JAG,Rise,MATCH,3,2.02
glym,304,65,40,14,25,193.4,19,12,5,7,10266,Rise,JAG,MATCH,3,2.02
leonzhet,259,52,44,20,8,159.3,18,9,4,5,10266,Rise,JAG,MATCH,3,2.02
GuhRVN,203,41,35,20,6,136.3,17,2,3,-1,10266,Rise,JAG,MATCH,3,2.02
Slag,195,42,45,12,-3,119.1,31,7,6,1,10266,Rise,JAG,MATCH,3,2.02
DmL,146,31,43,18,-12,84.5,13,5,7,-2,10266,Rise,JAG,MATCH,3,2.02
pavel,232,40,45,16,-5,154.9,12,3,5,-2,10294,RED,Rise,MATCH,2,2.02
vhz,226,42,42,8,0,165.4,27,9,9,0,10294,RED,Rise,MATCH,2,2.02
KHTEX,193,37,41,11,-4,137.5,28,4,7,-3,10294,RED,Rise,MATCH,2,2.02
FLG1,192,34,41,11,-7,109.5,31,4,7,-3,10294,RED,Rise,MATCH,2,2.02
Fatal,163,31,38,12,-7,103.0,32,1,5,-4,10294,RED,Rise,MATCH,2,2.02
glym,304,58,35,9,23,194.2,13,10,5,5,10294,Rise,RED,MATCH,2,2.02
DmL,230,44,38,10,6,136.9,27,9,4,5,10294,Rise,RED,MATCH,2,2.02
GuhRVN,202,41,34,15,7,146.9,22,6,2,4,10294,Rise,RED,MATCH,2,2.02
Slag,191,37,40,16,-3,101.6,19,3,5,-2,10294,Rise,RED,MATCH,2,2.02
leonzhet,175,27,37,20,-10,124.2,22,5,5,0,10294,Rise,RED,MATCH,2,2.02
gustt1nha,233,19,14,3,5,149.1,22,5,4,1,10339,IMP,Rise,MATCH,1,2.02
rst,217,17,15,4,2,127.1,13,0,1,-1,10339,IMP,Rise,MATCH,1,2.02
tuyz,202,13,17,5,-4,141.1,28,2,2,0,10339,IMP,Rise,MATCH,1,2.02
Biscoit1n,176,14,17,3,-3,116.3,27,3,2,1,10339,IMP,Rise,MATCH,1,2.02
Evilkyk,153,10,17,6,-7,95.6,31,0,3,-3,10339,IMP,Rise,MATCH,1,2.02
glym,259,20,14,5,6,183.2,7,7,0,7,10339,Rise,IMP,MATCH,1,2.02
leonzhet,223,17,15,2,2,141.9,35,3,4,-1,10339,Rise,IMP,MATCH,1,2.02
Slag,213,18,14,2,4,141.2,29,0,1,-1,10339,Rise,IMP,MATCH,1,2.02
DmL,208,15,15,11,0,194.8,22,2,3,-1,10339,Rise,IMP,MATCH,1,2.02
GuhRVN,136,10,15,7,-5,131.1,27,0,2,-2,10339,Rise,IMP,MATCH,1,2.02
GuhRVN,279,33,28,7,5,179.1,28,3,2,1,10343,Rise,GL,MATCH,2,2.02
Slag,234,29,30,10,-1,151.2,33,5,3,2,10343,Rise,GL,MATCH,2,2.02
leonzhet,158,17,32,13,-15,106.8,30,0,3,-3,10343,Rise,GL,MATCH,2,2.02
glym,144,18,33,8,-15,96.5,16,1,10,-9,10343,Rise,GL,MATCH,2,2.02
DmL,86,10,33,9,-23,52.8,19,2,9,-7,10343,Rise,GL,MATCH,2,2.02
mwzera,297,43,25,6,18,205.2,17,7,2,5,10343,GL,Rise,MATCH,2,2.02
Jonn,257,36,25,5,11,159.2,29,11,2,9,10343,GL,Rise,MATCH,2,2.02
fznnn,247,32,21,12,11,174.3,25,4,2,2,10343,GL,Rise,MATCH,2,2.02
Nyang,201,23,21,26,2,138.3,20,4,3,1,10343,GL,Rise,MATCH,2,2.02
JhoW,138,22,15,4,7,83.6,22,1,2,-1,10343,GL,Rise,MATCH,2,2.02
Slag,224,29,33,13,-4,128.6,29,4,2,2,10347,Rise,FURI,MATCH,2,2.02
GuhRVN,202,28,33,9,-5,140.9,22,1,5,-4,10347,Rise,FURI,MATCH,2,2.02
glym,156,20,38,7,-18,102.4,17,3,10,-7,10347,Rise,FURI,MATCH,2,2.02
leonzhet,150,23,28,9,-5,100.9,28,1,2,-1,10347,Rise,FURI,MATCH,2,2.02
DmL,126,17,33,6,-16,92.2,22,4,7,-3,10347,Rise,FURI,MATCH,2,2.02
xand,406,56,25,8,31,230.3,16,10,2,8,10347,FURI,Rise,MATCH,2,2.02
Nozwerr,286,39,20,19,19,167.7,20,3,1,2,10347,FURI,Rise,MATCH,2,2.02
qck,192,28,25,14,3,128.5,27,4,5,-1,10347,FURI,Rise,MATCH,2,2.02
Khalil,176,26,24,9,2,102.7,19,4,1,3,10347,FURI,Rise,MATCH,2,2.02
txddy,138,16,23,16,-7,87.5,18,5,4,1,10347,FURI,Rise,MATCH,2,2.02
glym,292,20,8,5,12,172.2,20,1,1,0,12073,Rise,paiN,MATCH,1,2.03
Slag,290,19,13,2,6,161.0,37,6,3,3,12073,Rise,paiN,MATCH,1,2.03
GuhRVN,253,18,13,5,5,161.3,14,2,0,2,12073,Rise,paiN,MATCH,1,2.03
DmL,209,14,8,4,6,175.8,20,3,0,3,12073,Rise,paiN,MATCH,1,2.03
leonzhet,164,9,10,6,-1,101.6,24,1,1,0,12073,Rise,paiN,MATCH,1,2.03
pepa,231,14,17,4,-3,142.9,23,2,1,1,12073,paiN,Rise,MATCH,1,2.03
kon4n,212,12,17,5,-5,112.7,19,1,5,-4,12073,paiN,Rise,MATCH,1,2.03
matheuzin,200,13,14,5,-1,112.7,28,1,0,1,12073,paiN,Rise,MATCH,1,2.03
murizzz,151,9,15,4,-6,93.8,23,1,4,-3,12073,paiN,Rise,MATCH,1,2.03
ryotzz,94,4,17,2,-13,67.5,10,0,3,-3,12073,paiN,Rise,MATCH,1,2.03
Evilkyk,283,40,22,16,18,150.7,22,3,2,1,12078,IMP,Rise,MATCH,2,2.03
Biscoit1n,232,30,28,13,2,138.4,17,8,4,4,12078,IMP,Rise,MATCH,2,2.03
gustt1nha,231,33,26,17,7,148.7,19,2,7,-5,12078,IMP,Rise,MATCH,2,2.03
tuyz,172,21,21,17,0,99.7,19,2,2,0,12078,IMP,Rise,MATCH,2,2.03
rst,168,24,22,7,2,100.0,14,5,3,2,12078,IMP,Rise,MATCH,2,2.03
glym,238,31,29,6,2,155.1,18,6,2,4,12078,Rise,IMP,MATCH,2,2.03
Slag,215,28,32,8,-4,142.5,16,6,7,-1,12078,Rise,IMP,MATCH,2,2.03
leonzhet,179,21,31,18,-10,94.2,8,2,5,-3,12078,Rise,IMP,MATCH,2,2.03
GuhRVN,175,21,28,16,-7,139.1,25,1,1,0,12078,Rise,IMP,MATCH,2,2.03
DmL,142,18,28,7,-10,86.9,14,3,5,-2,12078,Rise,IMP,MATCH,2,2.03
Slag,251,36,38,10,-2,164.2,22,7,8,-1,12080,Rise,paiN,MATCH,2,2.03
DmL,204,33,30,16,3,135.6,18,1,1,0,12080,Rise,paiN,MATCH,2,2.03
leonzhet,190,28,31,13,-3,119.4,16,5,4,1,12080,Rise,paiN,MATCH,2,2.03
glym,181,28,33,5,-5,102.0,15,7,8,-1,12080,Rise,paiN,MATCH,2,2.03
GuhRVN,159,22,35,15,-13,104.3,19,3,0,3,12080,Rise,paiN,MATCH,2,2.03
murizzz,265,47,27,16,20,153.0,22,4,9,-5,12080,paiN,Rise,MATCH,2,2.03
matheuzin,224,35,25,21,10,127.9,23,5,3,2,12080,paiN,Rise,MATCH,2,2.03
ryotzz,194,30,31,11,-1,115.8,11,4,2,2,12080,paiN,Rise,MATCH,2,2.03
kon4n,183,26,37,9,-11,121.8,12,6,8,-2,12080,paiN,Rise,MATCH,2,2.03
pepa,181,29,29,12,0,111.0,13,3,2,1,12080,paiN,Rise,MATCH,2,2.03
