Player,ACS,K,D,A,KD_DIFF,ADR,HS%,FK,FD,FK_FD_DIFF,match_id,Team,Opp_Team,Map,Num_maps,Patch
gtnziN,264,75,48,20,27,157.5,13,11,10,1,8298,VKS,IMP,MATCH,4,
sutecas,235,66,49,21,17,149.9,20,8,4,4,8298,VKS,IMP,MATCH,4,
frz,233,60,48,29,12,130.9,28,13,9,4,8298,VKS,IMP,MATCH,4,
saadhak,211,58,45,31,13,137.7,18,7,9,-2,8298,VKS,IMP,MATCH,4,
Sacy,194,55,45,30,10,134.6,26,7,1,6,8298,VKS,IMP,MATCH,4,
gustt1nha,227,61,59,16,2,148.3,18,7,9,-2,8298,IMP,VKS,MATCH,4,
Evilkyk,204,52,70,19,-18,134.4,29,6,6,0,8298,IMP,VKS,MATCH,4,
Biscoit1n,174,48,60,15,-12,114.1,18,4,8,-4,8298,IMP,VKS,MATCH,4,
rst,145,39,58,17,-19,115.4,17,7,5,2,8298,IMP,VKS,MATCH,4,
tuyz,137,35,67,11,-32,97.7,28,9,18,-9,8298,IMP,VKS,MATCH,4,
saadhak,332,52,30,17,22,175.4,26,11,3,8,8296,VKS,Vivo,MATCH,2,
gtnziN,275,47,27,12,20,177.9,13,7,2,5,8296,VKS,Vivo,MATCH,2,
Sacy,259,43,25,20,18,164.9,30,6,0,6,8296,VKS,Vivo,MATCH,2,
frz,174,32,29,9,3,114.5,22,8,9,-1,8296,VKS,Vivo,MATCH,2,
sutecas,89,14,29,16,-15,65.1,13,0,2,-2,8296,VKS,Vivo,MATCH,2,
patochovsk,247,39,36,12,3,176.4,21,6,7,-1,8296,Vivo,VKS,MATCH,2,
NikkoLAN,242,39,35,8,4,195.9,19,2,4,-2,8296,Vivo,VKS,MATCH,2,
NANZIN,146,23,40,10,-17,98.5,39,1,3,-2,8296,Vivo,VKS,MATCH,2,
flainzz,142,25,36,5,-11,93.3,15,3,6,-3,8296,Vivo,VKS,MATCH,2,
FLG1,87,14,41,7,-27,59.3,24,4,12,-8,8296,Vivo,VKS,MATCH,2,
frz,253,33,26,13,7,157.6,24,4,6,-2,8292,VKS,P,MATCH,2,
gtnziN,250,34,26,11,8,157.5,12,7,5,2,8292,VKS,P,MATCH,2,
sutecas,248,38,20,9,18,151.8,35,0,4,-4,8292,VKS,P,MATCH,2,
Sacy,209,26,23,17,3,142.2,26,2,3,-1,8292,VKS,P,MATCH,2,
saadhak,198,24,20,7,4,128.4,18,4,3,1,8292,VKS,P,MATCH,2,
rpAiva,266,35,34,7,1,179.0,28,11,1,10,8292,P,VKS,MATCH,2,
pavel,241,30,30,13,0,154.4,15,1,7,-6,8292,P,VKS,MATCH,2,
fAk,142,18,31,2,-13,84.3,19,6,5,1,8292,P,VKS,MATCH,2,
mNdS,131,16,31,10,-15,96.1,27,2,2,0,8292,P,VKS,MATCH,2,
zaxdeuS,128,16,29,7,-13,87.4,29,1,2,-1,8292,P,VKS,MATCH,2,
sutecas,254,37,24,9,13,154.9,45,5,0,5,8244,VKS,ZAM+,MATCH,2,1.14
gtnziN,238,32,30,9,2,140.2,22,6,12,-6,8244,VKS,ZAM+,MATCH,2,1.14
frz,216,31,26,10,5,119.1,30,5,4,1,8244,VKS,ZAM+,MATCH,2,1.14
Sacy,208,29,21,16,8,134.0,27,3,0,3,8244,VKS,ZAM+,MATCH,2,1.14
saadhak,205,29,21,10,8,132.5,20,3,2,1,8244,VKS,ZAM+,MATCH,2,1.14
zam,220,29,33,11,-4,139.8,21,8,8,0,8244,ZAM+,VKS,MATCH,2,1.14
rhamurti,206,28,31,12,-3,146.8,19,1,4,-3,8244,ZAM+,VKS,MATCH,2,1.14
DiMAS,169,23,30,5,-7,123.3,25,3,0,3,8244,ZAM+,VKS,MATCH,2,1.14
BRNWOWZK1,162,23,33,7,-10,101.1,20,4,4,0,8244,ZAM+,VKS,MATCH,2,1.14
deM0,143,19,31,10,-12,85.8,12,2,6,-4,8244,ZAM+,VKS,MATCH,2,1.14
frz,353,23,3,4,20,254.8,40,3,0,3,8232,VKS,mato,MATCH,1,1.14
gtnziN,348,19,9,6,10,193.4,11,4,1,3,8232,VKS,mato,MATCH,1,1.14
Sacy,239,13,8,10,5,159.6,21,1,0,1,8232,VKS,mato,MATCH,1,1.14
sutecas,219,14,4,8,10,211.9,34,4,1,3,8232,VKS,mato,MATCH,1,1.14
saadhak,102,6,5,4,1,64.6,20,1,1,0,8232,VKS,mato,MATCH,1,1.14
furlan,210,10,15,2,-5,143.8,46,2,4,-2,8232,mato,VKS,MATCH,1,1.14
goNtheKING,176,10,15,0,-5,93.8,18,0,2,-2,8232,mato,VKS,MATCH,1,1.14
batini,125,6,14,3,-8,87.4,14,1,3,-2,8232,mato,VKS,MATCH,1,1.14
brh1,52,2,15,5,-13,34.4,8,0,3,-3,8232,mato,VKS,MATCH,1,1.14
caixinhadesom,48,1,16,5,-15,43.4,15,0,1,-1,8232,mato,VKS,MATCH,1,1.14
murizzz,251,28,35,8,-7,172.0,19,6,8,-2,9101,paiN,VKS,MATCH,2,2.01
kon4n,175,23,29,10,-6,107.7,21,4,2,2,9101,paiN,VKS,MATCH,2,2.01
matheuzin,139,17,32,5,-15,90.0,20,4,4,0,9101,paiN,VKS,MATCH,2,2.01
pepa,114,11,31,11,-20,74.6,22,0,1,-1,9101,paiN,VKS,MATCH,2,2.01
ryotzz,96,10,28,2,-18,52.8,13,1,6,-5,9101,paiN,VKS,MATCH,2,2.01
gtnziN,312,38,21,13,17,197.2,21,8,2,6,9101,VKS,paiN,MATCH,2,2.01
frz,262,37,17,6,20,152.8,37,4,6,-2,9101,VKS,paiN,MATCH,2,2.01
sutecas,225,31,20,11,11,149.9,28,6,1,5,9101,VKS,paiN,MATCH,2,2.01
saadhak,205,28,14,9,14,106.8,8,2,3,-1,9101,VKS,paiN,MATCH,2,2.01
Sacy,177,20,17,17,3,128.1,22,1,3,-2,9101,VKS,paiN,MATCH,2,2.01
tuyz,270,16,18,4,-2,175.2,24,5,1,4,9260,IMP,VKS,MATCH,1,2.01
Evilkyk,193,12,16,5,-4,135.2,32,0,2,-2,9260,IMP,VKS,MATCH,1,2.01
Biscoit1n,164,10,16,3,-6,108.6,38,3,5,-2,9260,IMP,VKS,MATCH,1,2.01
gustt1nha,149,10,15,5,-5,85.9,22,0,1,-1,9260,IMP,VKS,MATCH,1,2.01
rst,138,9,15,1,-6,75.4,7,1,1,0,9260,IMP,VKS,MATCH,1,2.01
saadhak,260,16,9,7,7,171.5,16,1,0,1,9260,VKS,IMP,MATCH,1,2.01
sutecas,258,19,14,7,5,148.7,16,1,2,-1,9260,VKS,IMP,MATCH,1,2.01
Sacy,236,19,9,9,10,139.3,19,4,0,4,9260,VKS,IMP,MATCH,1,2.01
gtnziN,212,13,13,10,0,150.5,21,0,3,-3,9260,VKS,IMP,MATCH,1,2.01
frz,181,13,12,7,1,99.1,16,4,4,0,9260,VKS,IMP,MATCH,1,2.01
prozin,265,35,34,4,1,148.1,18,5,6,-1,9425,S5,VKS,MATCH,2,2.01
gaabxx,202,25,31,10,-6,175.3,27,6,7,-1,9425,S5,VKS,MATCH,2,2.01
fra,159,20,36,4,-16,101.6,28,2,6,-4,9425,S5,VKS,MATCH,2,2.01
deNaro,157,20,31,10,-11,121.7,18,0,4,-4,9425,S5,VKS,MATCH,2,2.01
fooX,144,18,31,5,-13,108.7,26,1,1,0,9425,S5,VKS,MATCH,2,2.01
gtnziN,292,38,25,14,13,197.9,18,5,4,1,9425,VKS,S5,MATCH,2,2.01
frz,282,40,23,12,17,150.9,21,8,4,4,9425,VKS,S5,MATCH,2,2.01
Sacy,234,29,24,29,5,153.1,20,6,2,4,9425,VKS,S5,MATCH,2,2.01
saadhak,224,32,21,11,11,135.0,27,4,2,2,9425,VKS,S5,MATCH,2,2.01
sutecas,163,24,25,6,-1,98.3,40,1,2,-1,9425,VKS,S5,MATCH,2,2.01
