Player,ACS,K,D,A,KD_DIFF,ADR,HS%,FK,FD,FK_FD_DIFF,match_id,Team,Opp_Team,Map,Num_maps,Patch
LEozin,232,38,32,3,6,127.7,21,10,1,9,4943,BD,Mix,MATCH,2,1.1
wilfps,209,33,34,7,-1,141.8,24,5,6,-1,4943,BD,Mix,MATCH,2,1.1
rhz,199,31,30,16,1,118.8,24,1,1,0,4943,BD,Mix,MATCH,2,1.1
rood,177,27,28,14,-1,110.1,15,6,4,2,4943,BD,Mix,MATCH,2,1.1
bezn1,138,17,35,15,-18,90.9,19,2,9,-7,4943,BD,Mix,MATCH,2,1.1
Biscoit1n,250,38,31,12,7,165.3,23,6,6,0,4943,Mix,BD,MATCH,2,1.1
txddy,219,37,27,7,10,124.0,25,3,4,-1,4943,Mix,BD,MATCH,2,1.1
Evilkyk,195,30,29,8,1,129.6,18,3,8,-5,4943,Mix,BD,MATCH,2,1.1
rst,191,32,27,7,5,113.7,17,4,3,1,4943,Mix,BD,MATCH,2,1.1
tuyz,158,22,32,15,-10,105.5,21,5,3,2,4943,Mix,BD,MATCH,2,1.1
rood,350,22,7,4,15,190.7,15,3,0,3,4905,BD,LAET,MATCH,1,1.11
LEozin,289,15,9,9,6,201.6,16,3,1,2,4905,BD,LAET,MATCH,1,1.11
bezn1,242,15,8,6,7,126.7,20,3,3,0,4905,BD,LAET,MATCH,1,1.11
rhz,175,11,6,6,5,120.5,38,0,0,0,4905,BD,LAET,MATCH,1,1.11
wilfps,165,11,7,4,4,94.4,29,2,1,1,4905,BD,LAET,MATCH,1,1.11
Valtuhhh,181,9,14,2,-5,169.3,26,2,1,1,4905,LAET,BD,MATCH,1,1.11
CrÃ¶wed,168,9,15,1,-6,106.3,17,2,5,-3,4905,LAET,BD,MATCH,1,1.11
SqL,152,7,15,4,-8,108.0,21,0,2,-2,4905,LAET,BD,MATCH,1,1.11
VictorBrf,151,7,15,2,-8,108.4,17,1,1,0,4905,LAET,BD,MATCH,1,1.11
Piko,110,5,15,5,-10,66.1,23,0,2,-2,4905,LAET,BD,MATCH,1,1.11
rood,266,24,12,2,12,149.2,29,5,0,5,4697,BD,novi,MATCH,1,1.1
LEozin,254,20,17,6,3,166.2,20,2,5,-3,4697,BD,novi,MATCH,1,1.1
bezn1,214,19,17,3,2,132.9,27,3,3,0,4697,BD,novi,MATCH,1,1.1
rhz,161,13,15,10,-2,115.6,13,2,1,1,4697,BD,novi,MATCH,1,1.1
wilfps,131,10,18,5,-8,87.5,26,1,1,0,4697,BD,novi,MATCH,1,1.1
Evilkyk,261,21,16,5,5,144.3,36,3,1,2,4697,novi,BD,MATCH,1,1.1
tuyz,224,18,20,5,-2,131.9,27,3,1,2,4697,novi,BD,MATCH,1,1.1
rst,216,19,11,2,8,133.8,38,0,3,-3,4697,novi,BD,MATCH,1,1.1
txddy,151,10,20,8,-10,109.9,17,3,3,0,4697,novi,BD,MATCH,1,1.1
Biscoit1n,148,11,19,5,-8,84.1,22,1,5,-4,4697,novi,BD,MATCH,1,1.1
fx,260,20,20,7,0,180.1,22,4,2,2,4694,DG,BD,MATCH,1,1.1
Leox,217,19,20,2,-1,138.5,18,5,2,3,4694,DG,BD,MATCH,1,1.1
GuhRVN,150,15,19,1,-4,81.4,14,0,0,0,4694,DG,BD,MATCH,1,1.1
valois,132,11,20,4,-9,79.5,24,4,4,0,4694,DG,BD,MATCH,1,1.1
glym,115,12,19,3,-7,79.5,20,1,4,-3,4694,DG,BD,MATCH,1,1.1
wilfps,281,26,12,7,14,171.6,29,2,1,1,4694,BD,DG,MATCH,1,1.1
LEozin,226,22,17,5,5,129.3,25,2,3,-1,4694,BD,DG,MATCH,1,1.1
bezn1,196,16,17,6,-1,119.7,14,3,5,-2,4694,BD,DG,MATCH,1,1.1
rhz,192,17,14,13,3,128.7,21,2,2,0,4694,BD,DG,MATCH,1,1.1
rood,189,17,17,4,0,123.7,31,3,3,0,4694,BD,DG,MATCH,1,1.1
LEozin,345,28,12,1,16,226.0,30,2,0,2,4030,BD,NEW,MATCH,1,1.1
rhz,222,16,11,11,5,126.6,39,2,3,-1,4030,BD,NEW,MATCH,1,1.1
rood,200,17,14,4,3,127.8,19,1,2,-1,4030,BD,NEW,MATCH,1,1.1
fooX,175,11,16,6,-5,82.2,22,2,3,-1,4030,BD,NEW,MATCH,1,1.1
wilfps,162,11,16,6,-5,109.9,26,2,4,-2,4030,BD,NEW,MATCH,1,1.1
Stevent,239,16,18,7,-2,168.5,11,4,4,0,4030,NEW,BD,MATCH,1,1.1
luqz,228,15,14,6,1,132.9,14,4,0,4,4030,NEW,BD,MATCH,1,1.1
duquera,195,15,18,7,-3,170.7,36,1,2,-1,4030,NEW,BD,MATCH,1,1.1
az9zelll,151,11,17,2,-6,84.5,17,3,3,0,4030,NEW,BD,MATCH,1,1.1
planE,146,12,17,5,-5,98.3,18,0,0,0,4030,NEW,BD,MATCH,1,1.1
Enjoy,283,22,11,6,11,171.0,18,2,0,2,4029,novi,BD,MATCH,1,1.1
txddy,243,17,13,7,4,162.2,20,2,1,1,4029,novi,BD,MATCH,1,1.1
Biscoit1n,239,18,14,7,4,133.3,28,5,0,5,4029,novi,BD,MATCH,1,1.1
tuyz,188,15,13,2,2,120.0,34,5,4,1,4029,novi,BD,MATCH,1,1.1
rafz,103,7,15,4,-8,72.5,30,1,1,0,4029,novi,BD,MATCH,1,1.1
rhz,262,20,15,3,5,147.7,31,1,4,-3,4029,BD,novi,MATCH,1,1.1
rood,222,16,14,1,2,176.8,24,4,3,1,4029,BD,novi,MATCH,1,1.1
fooX,160,13,17,4,-4,95.2,19,0,1,-1,4029,BD,novi,MATCH,1,1.1
wilfps,159,9,17,6,-8,108.1,26,0,3,-3,4029,BD,novi,MATCH,1,1.1
LEozin,132,8,17,3,-9,80.2,20,1,4,-3,4029,BD,novi,MATCH,1,1.1
wilfps,292,21,13,8,8,211.7,19,1,1,0,4026,BD,DG,MATCH,1,1.1
rhz,270,21,8,5,13,153.5,35,0,1,-1,4026,BD,DG,MATCH,1,1.1
rood,199,15,14,6,1,130.4,15,3,3,0,4026,BD,DG,MATCH,1,1.1
fooX,190,15,16,0,-1,101.3,38,4,2,2,4026,BD,DG,MATCH,1,1.1
LEozin,173,12,13,4,-1,109.4,20,3,2,1,4026,BD,DG,MATCH,1,1.1
qck,514,34,17,2,17,305.9,28,6,1,5,4026,DG,BD,MATCH,1,1.1
69kg,180,11,18,6,-7,166.5,23,1,2,-1,4026,DG,BD,MATCH,1,1.1
Plato,124,8,17,5,-9,81.1,19,0,4,-4,4026,DG,BD,MATCH,1,1.1
Leox,94,6,18,8,-12,104.4,18,1,3,-2,4026,DG,BD,MATCH,1,1.1
rst,80,5,16,3,-11,48.6,23,1,1,0,4026,DG,BD,MATCH,1,1.1
pollo,269,19,13,1,6,163.4,24,6,2,4,3475,VIMD,BD,MATCH,1,1.09
Sacy,268,19,9,7,10,181.3,25,1,2,-1,3475,VIMD,BD,MATCH,1,1.09
pepa,184,14,14,5,0,114.1,32,0,0,0,3475,VIMD,BD,MATCH,1,1.09
prozin,168,10,13,5,-3,95.5,16,4,3,1,3475,VIMD,BD,MATCH,1,1.09
Masu,147,12,11,8,1,95.4,22,2,0,2,3475,VIMD,BD,MATCH,1,1.09
rhz,292,21,15,3,6,179.3,28,3,2,1,3475,BD,VIMD,MATCH,1,1.09
LEozin,220,13,14,5,-1,150.5,15,0,2,-2,3475,BD,VIMD,MATCH,1,1.09
fooX,183,12,15,7,-3,117.1,29,1,5,-4,3475,BD,VIMD,MATCH,1,1.09
bezn1,129,7,15,8,-8,70.6,3,2,2,0,3475,BD,VIMD,MATCH,1,1.09
Ossada,88,7,15,0,-8,72.3,22,1,2,-1,3475,BD,VIMD,MATCH,1,1.09
Fxz,248,17,15,7,2,147.5,15,3,4,-1,3470,novi,BD,MATCH,1,1.09
Biscoit1n,201,14,18,3,-4,148.1,29,6,4,2,3470,novi,BD,MATCH,1,1.09
glym,196,14,17,2,-3,110.4,12,1,0,1,3470,novi,BD,MATCH,1,1.09
kato,157,10,15,6,-5,120.0,14,0,2,-2,3470,novi,BD,MATCH,1,1.09
twitch,106,8,16,9,-8,67.1,24,0,1,-1,3470,novi,BD,MATCH,1,1.09
bezn1,273,21,16,6,5,153.2,49,3,3,0,3470,BD,novi,MATCH,1,1.09
LEozin,228,17,12,8,5,133.1,9,1,0,1,3470,BD,novi,MATCH,1,1.09
DonPablito,211,17,15,3,2,104.7,23,5,4,1,3470,BD,novi,MATCH,1,1.09
fooX,185,14,9,7,5,127.1,15,1,1,0,3470,BD,novi,MATCH,1,1.09
rhz,182,12,11,12,1,131.5,16,1,2,-1,3470,BD,novi,MATCH,1,1.09
NagZ,346,20,2,0,18,195.5,21,7,1,6,3467,Estral,BD,MATCH,1,1.09
saadhak,345,17,5,7,12,218.0,20,1,0,1,3467,Estral,BD,MATCH,1,1.09
Nozwerr,275,14,3,8,11,175.3,26,1,0,1,3467,Estral,BD,MATCH,1,1.09
puleule,154,8,5,13,3,85.6,19,2,0,2,3467,Estral,BD,MATCH,1,1.09
Leazo,141,8,4,1,4,103.9,53,1,1,0,3467,Estral,BD,MATCH,1,1.09
bezn1,140,5,13,2,-8,91.6,32,0,4,-4,3467,BD,Estral,MATCH,1,1.09
DonPablito,131,6,13,2,-7,71.2,13,1,1,0,3467,BD,Estral,MATCH,1,1.09
fooX,123,4,14,1,-10,90.8,16,1,2,-1,3467,BD,Estral,MATCH,1,1.09
rhz,71,3,13,0,-10,58.9,33,0,3,-3,3467,BD,Estral,MATCH,1,1.09
LEozin,49,1,14,1,-13,34.4,50,0,2,-2,3467,BD,Estral,MATCH,1,1.09
patochovsk,234,47,41,12,6,137.4,15,8,6,2,2977,FAKE,BD,MATCH,3,1.08
NANZIN,225,48,42,18,6,150.7,35,4,9,-5,2977,FAKE,BD,MATCH,3,1.08
FLG1,200,47,41,8,6,132.7,29,5,1,4,2977,FAKE,BD,MATCH,3,1.08
Tecnosh,183,39,40,7,-1,111.7,10,11,12,-1,2977,FAKE,BD,MATCH,3,1.08
GTFAFMX,164,34,36,26,-2,99.5,18,2,3,-1,2977,FAKE,BD,MATCH,3,1.08
fooX,226,48,39,10,9,131.3,25,9,9,0,2977,BD,FAKE,MATCH,3,1.08
rhz,217,44,43,20,1,150.4,36,3,4,-1,2977,BD,FAKE,MATCH,3,1.08
NikkoLAN,184,37,45,7,-8,104.5,16,11,6,5,2977,BD,FAKE,MATCH,3,1.08
PryZee,174,39,45,13,-6,111.1,12,3,5,-2,2977,BD,FAKE,MATCH,3,1.08
RoY,141,32,43,7,-11,83.7,24,5,6,-1,2977,BD,FAKE,MATCH,3,1.08
NikkoLAN,290,41,27,7,14,169.9,27,8,1,7,2957,BD,Gala,MATCH,2,1.08
rhz,236,35,21,11,14,145.4,35,4,5,-1,2957,BD,Gala,MATCH,2,1.08
fooX,219,30,25,9,5,137.2,19,3,3,0,2957,BD,Gala,MATCH,2,1.08
PryZee,191,26,23,11,3,121.0,27,5,3,2,2957,BD,Gala,MATCH,2,1.08
RoY,184,24,29,12,-5,123.5,22,3,4,-1,2957,BD,Gala,MATCH,2,1.08
pôti,215,29,30,4,-1,118.9,22,6,6,0,2957,Gala,BD,MATCH,2,1.08
stylerino,198,27,31,4,-4,113.6,20,1,2,-1,2957,Gala,BD,MATCH,2,1.08
axeddy,197,28,31,4,-3,122.5,29,6,4,2,2957,Gala,BD,MATCH,2,1.08
mascot,194,24,31,14,-7,128.9,18,0,4,-4,2957,Gala,BD,MATCH,2,1.08
Double,151,17,33,11,-16,102.6,24,3,7,-4,2957,Gala,BD,MATCH,2,1.08
bezn1,297,26,22,4,4,175.3,18,5,4,1,5998,BD,VKS,MATCH,1,1.12
rhz,174,16,18,6,-2,122.2,22,2,1,1,5998,BD,VKS,MATCH,1,1.12
rood,141,14,19,8,-5,87.5,19,2,2,0,5998,BD,VKS,MATCH,1,1.12
wilfps,140,9,22,7,-13,137.1,13,0,1,-1,5998,BD,VKS,MATCH,1,1.12
LEozin,135,14,21,0,-7,78.8,13,2,7,-5,5998,BD,VKS,MATCH,1,1.12
BrinkssJ,327,32,15,3,17,230.2,20,4,2,2,5998,VKS,BD,MATCH,1,1.12
cad,262,23,15,7,8,170.8,23,6,2,4,5998,VKS,BD,MATCH,1,1.12
fuzari,207,18,17,6,1,125.8,32,2,5,-3,5998,VKS,BD,MATCH,1,1.12
gtnziN,168,14,16,5,-2,114.7,14,2,2,0,5998,VKS,BD,MATCH,1,1.12
deNaro,145,15,16,6,-1,90.7,14,1,0,1,5998,VKS,BD,MATCH,1,1.12
Maverick,307,25,15,6,10,162.1,24,3,2,1,5995,oNe,BD,MATCH,1,1.12
ntk,255,20,17,3,3,181.6,18,3,3,0,5995,oNe,BD,MATCH,1,1.12
Zap,246,21,14,4,7,140.0,21,3,1,2,5995,oNe,BD,MATCH,1,1.12
Cpx,171,14,15,2,-1,103.0,26,3,2,1,5995,oNe,BD,MATCH,1,1.12
Champzera,104,8,15,5,-7,66.2,23,2,1,1,5995,oNe,BD,MATCH,1,1.12
bezn1,301,25,15,3,10,192.4,19,4,2,2,5995,BD,oNe,MATCH,1,1.12
LEozin,215,18,18,6,0,122.0,11,1,4,-3,5995,BD,oNe,MATCH,1,1.12
rhz,177,13,17,6,-4,111.7,16,0,2,-2,5995,BD,oNe,MATCH,1,1.12
rood,177,14,19,5,-5,108.5,27,3,2,1,5995,BD,oNe,MATCH,1,1.12
wilfps,84,6,19,6,-13,52.3,58,1,4,-3,5995,BD,oNe,MATCH,1,1.12
Veroneze,327,50,24,7,26,184.9,25,10,0,10,5283,paiN,BD,MATCH,2,1.12
murizzz,255,37,29,13,8,168.0,26,8,6,2,5283,paiN,BD,MATCH,2,1.12
Txozin,206,33,27,5,6,119.8,36,6,3,3,5283,paiN,BD,MATCH,2,1.12
matheuzin,147,22,22,4,0,100.4,24,4,3,1,5283,paiN,BD,MATCH,2,1.12
kon4n,146,24,25,14,-1,83.5,28,0,3,-3,5283,paiN,BD,MATCH,2,1.12
rood,206,28,29,12,-1,149.8,19,3,6,-3,5283,BD,paiN,MATCH,2,1.12
bezn1,200,28,36,6,-8,111.2,17,5,4,1,5283,BD,paiN,MATCH,2,1.12
wilfps,178,25,35,7,-10,114.6,29,4,10,-6,5283,BD,paiN,MATCH,2,1.12
rhz,163,25,33,12,-8,102.3,28,0,1,-1,5283,BD,paiN,MATCH,2,1.12
LEozin,146,21,33,10,-12,99.9,16,3,7,-4,5283,BD,paiN,MATCH,2,1.12
NandeX,221,24,31,17,-7,142.7,18,7,2,5,5274,tiob,BD,MATCH,2,1.12
Hastad,209,24,30,6,-6,123.0,21,4,5,-1,5274,tiob,BD,MATCH,2,1.12
Igaum,185,23,26,8,-3,108.2,20,3,3,0,5274,tiob,BD,MATCH,2,1.12
dtt1,162,22,28,3,-6,85.3,16,1,2,-1,5274,tiob,BD,MATCH,2,1.12
Rub1ka,130,18,29,8,-11,75.5,21,3,6,-3,5274,tiob,BD,MATCH,2,1.12
bezn1,273,33,26,9,7,167.6,21,10,7,3,5274,BD,tiob,MATCH,2,1.12
wilfps,272,33,23,13,10,155.9,20,4,4,0,5274,BD,tiob,MATCH,2,1.12
LEozin,231,31,22,10,9,128.2,16,1,3,-2,5274,BD,tiob,MATCH,2,1.12
rood,183,22,24,19,-2,120.8,21,2,3,-1,5274,BD,tiob,MATCH,2,1.12
rhz,174,25,16,10,9,99.0,21,1,1,0,5274,BD,tiob,MATCH,2,1.12
Evilkyk,246,41,30,19,11,183.7,29,6,3,3,8297,IMP,BD,MATCH,2,
tuyz,242,42,33,3,9,166.9,31,7,7,0,8297,IMP,BD,MATCH,2,
gustt1nha,216,34,36,13,-2,137.7,16,4,7,-3,8297,IMP,BD,MATCH,2,
Biscoit1n,211,34,29,12,5,129.8,30,3,6,-3,8297,IMP,BD,MATCH,2,
rst,173,28,29,12,-1,102.1,17,0,4,-4,8297,IMP,BD,MATCH,2,
pollo,223,39,35,5,4,146.0,28,13,4,9,8297,BD,IMP,MATCH,2,
bezn1,222,33,37,22,-4,150.2,24,1,1,0,8297,BD,IMP,MATCH,2,
LEozin,214,32,39,15,-7,137.7,16,8,6,2,8297,BD,IMP,MATCH,2,
rood,183,29,33,10,-4,126.5,14,4,3,1,8297,BD,IMP,MATCH,2,
wilfps,150,24,35,20,-11,92.1,17,1,6,-5,8297,BD,IMP,MATCH,2,
pollo,244,60,39,5,21,139.9,22,16,5,11,8295,BD,TREM,MATCH,3,
rood,226,50,39,21,11,133.9,15,7,7,0,8295,BD,TREM,MATCH,3,
wilfps,200,49,41,17,8,139.1,27,8,3,5,8295,BD,TREM,MATCH,3,
LEozin,195,41,49,17,-8,129.5,14,4,9,-5,8295,BD,TREM,MATCH,3,
bezn1,172,38,42,23,-4,112.5,21,6,1,5,8295,BD,TREM,MATCH,3,
mart1nz,249,55,55,13,0,153.7,14,5,7,-2,8295,TREM,BD,MATCH,3,
feh,180,44,42,14,2,131.4,20,6,10,-4,8295,TREM,BD,MATCH,3,
Champzera,179,41,50,13,-9,109.2,21,4,8,-4,8295,TREM,BD,MATCH,3,
luqz,172,38,42,24,-4,106.3,29,3,6,-3,8295,TREM,BD,MATCH,3,
nandinh0,142,32,49,10,-17,95.8,25,7,10,-3,8295,TREM,BD,MATCH,3,
bezn1,305,36,11,19,25,188.5,23,1,1,0,8247,BD,Swed,MATCH,2,1.14
rood,264,32,16,11,16,146.8,13,5,2,3,8247,BD,Swed,MATCH,2,1.14
LEozin,260,27,26,9,1,141.5,20,7,5,2,8247,BD,Swed,MATCH,2,1.14
pollo,239,29,16,5,13,134.4,14,5,4,1,8247,BD,Swed,MATCH,2,1.14
Koy,149,21,10,10,11,74.0,17,0,2,-2,8247,BD,Swed,MATCH,2,1.14
weelzin,198,18,29,5,-11,129.4,20,7,3,4,8247,Swed,BD,MATCH,2,1.14
snoopy,175,18,27,4,-9,115.2,14,1,5,-4,8247,Swed,BD,MATCH,2,1.14
Fatmarino,149,16,30,4,-14,104.7,22,1,3,-2,8247,Swed,BD,MATCH,2,1.14
Lukz,138,15,29,5,-14,82.4,13,3,5,-2,8247,Swed,BD,MATCH,2,1.14
rNt1,129,12,30,8,-18,89.9,24,2,2,0,8247,Swed,BD,MATCH,2,1.14
pollo,323,24,12,4,12,185.7,31,8,2,6,8238,BD,3P,MATCH,1,1.14
bezn1,275,19,12,10,7,177.2,19,2,1,1,8238,BD,3P,MATCH,1,1.14
LEozin,237,17,14,5,3,145.7,5,3,1,2,8238,BD,3P,MATCH,1,1.14
rood,168,14,14,6,0,100.4,14,1,1,0,8238,BD,3P,MATCH,1,1.14
Koy,118,8,15,13,-7,66.7,15,1,1,0,8238,BD,3P,MATCH,1,1.14
LuxXyyzx,254,16,17,4,-1,147.6,11,1,2,-1,8238,3P,BD,MATCH,1,1.14
shelbyN,246,20,15,2,5,135.6,28,0,4,-4,8238,3P,BD,MATCH,1,1.14
youngzeraaa,171,12,18,5,-6,98.0,16,3,4,-1,8238,3P,BD,MATCH,1,1.14
N3RDOLA,159,12,16,5,-4,98.3,28,2,2,0,8238,3P,BD,MATCH,1,1.14
toddy,111,7,16,4,-9,77.0,6,0,3,-3,8238,3P,BD,MATCH,1,1.14
bezn1,303,25,14,14,11,192.9,32,2,1,1,9324,BD,DLWZK,MATCH,1,2.01
LEozin,213,17,16,8,1,140.2,23,4,3,1,9324,BD,DLWZK,MATCH,1,2.01
wilfps,166,13,20,3,-7,97.6,24,3,3,0,9324,BD,DLWZK,MATCH,1,2.01
pollo,150,12,17,10,-5,104.1,20,2,2,0,9324,BD,DLWZK,MATCH,1,2.01
rood,117,10,17,5,-7,83.0,15,1,3,-2,9324,BD,DLWZK,MATCH,1,2.01
BRNWOWZK1,258,23,14,7,9,151.3,18,2,3,-1,9324,DLWZK,BD,MATCH,1,2.01
heat,226,20,14,3,6,151.4,24,6,2,4,9324,DLWZK,BD,MATCH,1,2.01
fluyr,205,17,17,5,0,120.4,19,0,2,-2,9324,DLWZK,BD,MATCH,1,2.01
zam,204,16,17,10,-1,135.1,15,3,3,0,9324,DLWZK,BD,MATCH,1,2.01
rhamurti,109,8,15,6,-7,66.0,10,1,2,-1,9324,DLWZK,BD,MATCH,1,2.01
furq,246,15,16,2,-1,163.9,13,4,1,3,9317,semT,BD,MATCH,1,2.01
RND,176,11,17,1,-6,96.3,27,1,4,-3,9317,semT,BD,MATCH,1,2.01
DABLIW,153,10,15,3,-5,88.7,28,3,2,1,9317,semT,BD,MATCH,1,2.01
kid,143,10,15,6,-5,95.8,15,0,2,-2,9317,semT,BD,MATCH,1,2.01
GjW,108,8,16,4,-8,64.4,35,2,0,2,9317,semT,BD,MATCH,1,2.01
LEozin,328,21,11,8,10,195.4,16,2,2,0,9317,BD,semT,MATCH,1,2.01
rood,325,24,8,2,16,182.6,19,3,2,1,9317,BD,semT,MATCH,1,2.01
pollo,202,15,12,5,3,135.4,25,1,2,-1,9317,BD,semT,MATCH,1,2.01
wilfps,174,10,11,8,-1,121.0,21,2,2,0,9317,BD,semT,MATCH,1,2.01
bezn1,138,9,12,8,-3,90.8,19,1,2,-1,9317,BD,semT,MATCH,1,2.01
