Player,ACS,K,D,A,KD_DIFF,ADR,HS%,FK,FD,FK_FD_DIFF,match_id,Team,Opp_Team,Map,Num_maps,Patch
tuyz,250,52,42,18,10,170.1,18,5,5,0,6527,IMP,paiN,MATCH,3,
txddy,238,51,44,9,7,146.2,27,3,8,-5,6527,IMP,paiN,MATCH,3,
Biscoit1n,192,44,49,4,-5,102.9,16,8,14,-6,6527,IMP,paiN,MATCH,3,
rst,172,32,41,20,-9,120.3,15,3,8,-5,6527,IMP,paiN,MATCH,3,
Evilkyk,162,35,46,18,-11,104.3,15,2,6,-4,6527,IMP,paiN,MATCH,3,
kon4n,244,52,35,23,17,161.6,25,5,2,3,6527,paiN,IMP,MATCH,3,
Txozin,244,57,43,6,14,145.3,32,7,3,4,6527,paiN,IMP,MATCH,3,
murizzz,211,37,49,23,-12,132.7,20,12,4,8,6527,paiN,IMP,MATCH,3,
Veroneze,183,39,44,11,-5,128.5,29,8,6,2,6527,paiN,IMP,MATCH,3,
matheuzin,160,37,43,4,-6,103.1,28,9,6,3,6527,paiN,IMP,MATCH,3,
matheuzin,288,39,17,9,22,160.9,36,7,3,4,6054,paiN,ITZA,MATCH,2,1.12
Txozin,260,33,18,7,15,167.8,27,5,1,4,6054,paiN,ITZA,MATCH,2,1.12
Veroneze,252,33,18,9,15,167.0,22,2,2,0,6054,paiN,ITZA,MATCH,2,1.12
kon4n,209,27,17,7,10,135.7,24,10,2,8,6054,paiN,ITZA,MATCH,2,1.12
murizzz,193,23,15,11,8,97.9,16,1,2,-1,6054,paiN,ITZA,MATCH,2,1.12
isa,228,25,31,4,-6,158.7,25,4,3,1,6054,ITZA,paiN,MATCH,2,1.12
celinett,165,16,30,9,-14,102.8,9,2,7,-5,6054,ITZA,paiN,MATCH,2,1.12
Shizue,151,18,31,4,-13,109.0,15,1,1,0,6054,ITZA,paiN,MATCH,2,1.12
shyz,139,14,32,4,-18,76.9,12,2,11,-9,6054,ITZA,paiN,MATCH,2,1.12
tayhuhu,125,12,31,9,-19,68.2,15,1,3,-2,6054,ITZA,paiN,MATCH,2,1.12
kon4n,239,57,47,22,10,169.9,31,7,5,2,3235,NOOR,FF,MATCH,3,1.08
murizzz,218,54,52,10,2,118.8,10,13,6,7,3235,NOOR,FF,MATCH,3,1.08
Txozin,188,52,45,14,7,121.8,24,6,4,2,3235,NOOR,FF,MATCH,3,1.08
ole,185,40,44,21,-4,121.3,11,1,2,-1,3235,NOOR,FF,MATCH,3,1.08
matheuzin,177,39,49,22,-10,102.2,26,13,11,2,3235,NOOR,FF,MATCH,3,1.08
v1xen,265,61,43,18,18,161.8,26,5,3,2,3235,FF,NOOR,MATCH,3,1.08
krain,201,46,42,26,4,122.9,12,3,3,0,3235,FF,NOOR,MATCH,3,1.08
dragonite,194,41,53,13,-12,119.7,21,6,6,0,3235,FF,NOOR,MATCH,3,1.08
delevingne,189,48,48,7,0,109.1,11,8,17,-9,3235,FF,NOOR,MATCH,3,1.08
fzkk,182,40,56,15,-16,117.8,10,6,11,-5,3235,FF,NOOR,MATCH,3,1.08
pollo,271,60,50,9,10,155.1,21,11,12,-1,3213,VIMD,NOOR,MATCH,3,1.08
Sacy,234,57,47,13,10,143.8,27,6,7,-1,3213,VIMD,NOOR,MATCH,3,1.08
prozin,161,37,49,11,-12,106.1,16,2,8,-6,3213,VIMD,NOOR,MATCH,3,1.08
Masu,157,37,52,29,-15,105.8,18,3,2,1,3213,VIMD,NOOR,MATCH,3,1.08
pepa,133,26,54,16,-28,86.4,16,7,9,-2,3213,VIMD,NOOR,MATCH,3,1.08
murizzz,223,52,41,18,11,135.1,19,8,8,0,3213,NOOR,VIMD,MATCH,3,1.08
matheuzin,218,53,47,23,6,138.2,29,9,7,2,3213,NOOR,VIMD,MATCH,3,1.08
ole,208,51,40,29,11,132.2,16,6,0,6,3213,NOOR,VIMD,MATCH,3,1.08
kon4n,203,49,42,24,7,138.7,21,7,7,0,3213,NOOR,VIMD,MATCH,3,1.08
Txozin,187,46,49,11,-3,141.6,17,8,7,1,3213,NOOR,VIMD,MATCH,3,1.08
pancada,225,31,25,6,6,141.7,23,4,4,0,3170,B4,NOOR,MATCH,2,1.08
akemy,208,26,28,14,-2,138.6,23,2,2,0,3170,B4,NOOR,MATCH,2,1.08
frz,199,26,29,11,-3,128.7,16,3,4,-1,3170,B4,NOOR,MATCH,2,1.08
xand,174,22,33,6,-11,103.5,19,8,7,1,3170,B4,NOOR,MATCH,2,1.08
v1nny,134,17,31,6,-14,86.7,22,0,5,-5,3170,B4,NOOR,MATCH,2,1.08
murizzz,260,41,26,4,15,177.5,16,5,2,3,3170,NOOR,B4,MATCH,2,1.08
kon4n,233,31,27,13,4,142.7,26,6,8,-2,3170,NOOR,B4,MATCH,2,1.08
matheuzin,199,27,26,11,1,104.3,23,9,4,5,3170,NOOR,B4,MATCH,2,1.08
Txozin,184,26,22,7,4,136.4,23,1,0,1,3170,NOOR,B4,MATCH,2,1.08
ole,159,21,23,9,-2,99.6,7,1,3,-2,3170,NOOR,B4,MATCH,2,1.08
NANZIN,243,39,29,9,10,136.5,21,5,1,4,3143,FAKE,NOOR,MATCH,2,1.08
patochovsk,241,37,29,9,8,159.5,14,6,5,1,3143,FAKE,NOOR,MATCH,2,1.08
GTFAFMX,200,30,27,15,3,126.8,13,2,1,1,3143,FAKE,NOOR,MATCH,2,1.08
FLG1,163,24,33,9,-9,111.3,34,2,3,-1,3143,FAKE,NOOR,MATCH,2,1.08
Tecnosh,106,16,36,5,-20,67.3,14,4,15,-11,3143,FAKE,NOOR,MATCH,2,1.08
ole,252,39,30,14,9,145.9,16,6,0,6,3143,NOOR,FAKE,MATCH,2,1.08
kon4n,237,34,26,16,8,149.4,20,5,3,2,3143,NOOR,FAKE,MATCH,2,1.08
murizzz,189,31,28,5,3,104.8,6,4,7,-3,3143,NOOR,FAKE,MATCH,2,1.08
Txozin,179,27,32,16,-5,120.0,16,1,6,-5,3143,NOOR,FAKE,MATCH,2,1.08
matheuzin,158,23,30,13,-7,107.4,15,9,3,6,3143,NOOR,FAKE,MATCH,2,1.08
bld,232,30,32,13,-2,156.9,21,4,4,0,2978,FKL,NOOR,MATCH,2,1.08
mch,202,30,31,5,-1,119.1,17,3,1,2,2978,FKL,NOOR,MATCH,2,1.08
cogu,167,25,31,6,-6,103.5,21,5,12,-7,2978,FKL,NOOR,MATCH,2,1.08
bezn1,166,21,34,9,-13,102.6,17,1,3,-2,2978,FKL,NOOR,MATCH,2,1.08
pava,155,17,33,13,-16,110.0,18,2,5,-3,2978,FKL,NOOR,MATCH,2,1.08
Txozin,275,40,25,14,15,167.2,24,7,2,5,2978,NOOR,FKL,MATCH,2,1.08
murizzz,268,42,23,8,19,154.5,31,8,5,3,2978,NOOR,FKL,MATCH,2,1.08
matheuzin,190,28,27,16,1,118.4,25,6,2,4,2978,NOOR,FKL,MATCH,2,1.08
kon4n,181,25,24,10,1,132.4,22,2,3,-1,2978,NOOR,FKL,MATCH,2,1.08
ole,179,26,24,13,2,103.4,10,2,3,-1,2978,NOOR,FKL,MATCH,2,1.08
Veroneze,327,50,24,7,26,184.9,25,10,0,10,5283,paiN,BD,MATCH,2,1.12
murizzz,255,37,29,13,8,168.0,26,8,6,2,5283,paiN,BD,MATCH,2,1.12
Txozin,206,33,27,5,6,119.8,36,6,3,3,5283,paiN,BD,MATCH,2,1.12
matheuzin,147,22,22,4,0,100.4,24,4,3,1,5283,paiN,BD,MATCH,2,1.12
kon4n,146,24,25,14,-1,83.5,28,0,3,-3,5283,paiN,BD,MATCH,2,1.12
rood,206,28,29,12,-1,149.8,19,3,6,-3,5283,BD,paiN,MATCH,2,1.12
bezn1,200,28,36,6,-8,111.2,17,5,4,1,5283,BD,paiN,MATCH,2,1.12
wilfps,178,25,35,7,-10,114.6,29,4,10,-6,5283,BD,paiN,MATCH,2,1.12
rhz,163,25,33,12,-8,102.3,28,0,1,-1,5283,BD,paiN,MATCH,2,1.12
LEozin,146,21,33,10,-12,99.9,16,3,7,-4,5283,BD,paiN,MATCH,2,1.12
murizzz,334,40,25,16,15,168.0,16,10,3,7,5273,paiN,dogz,MATCH,2,1.12
Txozin,228,27,22,13,5,145.7,18,3,1,2,5273,paiN,dogz,MATCH,2,1.12
kon4n,220,32,18,17,14,137.9,26,3,1,2,5273,paiN,dogz,MATCH,2,1.12
Veroneze,205,31,19,6,12,133.5,23,5,5,0,5273,paiN,dogz,MATCH,2,1.12
matheuzin,158,24,19,9,5,86.3,25,2,5,-3,5273,paiN,dogz,MATCH,2,1.12
toezin,204,21,34,11,-13,142.9,13,3,6,-3,5273,dogz,paiN,MATCH,2,1.12
magicwow1,192,24,33,3,-9,117.3,16,5,6,-1,5273,dogz,paiN,MATCH,2,1.12
dan,179,24,27,10,-3,117.9,16,2,2,0,5273,dogz,paiN,MATCH,2,1.12
Otsuka,155,19,30,11,-11,95.6,13,3,3,0,5273,dogz,paiN,MATCH,2,1.12
PedroGOD,129,15,30,6,-15,84.6,17,2,6,-4,5273,dogz,paiN,MATCH,2,1.12
Veroneze,275,40,27,8,13,160.8,31,9,5,4,5174,paiN,1tap,MATCH,2,1.1
kon4n,271,40,25,11,15,164.7,21,5,2,3,5174,paiN,1tap,MATCH,2,1.1
murizzz,231,35,21,11,14,147.3,26,6,1,5,5174,paiN,1tap,MATCH,2,1.1
matheuzin,180,26,26,10,0,108.9,31,4,1,3,5174,paiN,1tap,MATCH,2,1.1
Txozin,157,25,27,10,-2,98.2,29,3,6,-3,5174,paiN,1tap,MATCH,2,1.1
ttv,212,31,32,4,-1,128.0,26,4,5,-1,5174,1tap,paiN,MATCH,2,1.1
ttv,209,30,31,9,-1,124.7,15,2,4,-2,5174,1tap,paiN,MATCH,2,1.1
Random,177,26,34,9,-8,119.4,28,3,5,-2,5174,1tap,paiN,MATCH,2,1.1
ArtBaue,159,22,34,10,-12,95.9,24,4,4,0,5174,1tap,paiN,MATCH,2,1.1
fpX,130,17,35,10,-18,89.5,30,2,9,-7,5174,1tap,paiN,MATCH,2,1.1
Physicx,188,11,14,5,-3,153.7,6,1,0,1,5025,Furn,paiN,MATCH,1,1.1
pit,163,7,13,2,-6,107.3,11,0,1,-1,5025,Furn,paiN,MATCH,1,1.1
p9dro,160,7,15,2,-8,91.7,21,1,1,0,5025,Furn,paiN,MATCH,1,1.1
Vai,108,4,14,5,-10,76.4,14,0,3,-3,5025,Furn,paiN,MATCH,1,1.1
Fedrigues,94,4,15,1,-11,67.7,16,0,8,-8,5025,Furn,paiN,MATCH,1,1.1
kon4n,377,21,8,3,13,229.1,38,8,0,8,5025,paiN,Furn,MATCH,1,1.1
murizzz,286,17,7,10,10,189.1,22,1,0,1,5025,paiN,Furn,MATCH,1,1.1
Veroneze,208,13,5,4,8,155.9,26,1,2,-1,5025,paiN,Furn,MATCH,1,1.1
matheuzin,177,11,6,7,5,90.9,30,2,0,2,5025,paiN,Furn,MATCH,1,1.1
Txozin,177,8,7,8,1,124.1,10,1,0,1,5025,paiN,Furn,MATCH,1,1.1
ArtBaue,274,19,15,3,4,195.2,21,3,0,3,4797,1tap,paiN,MATCH,1,1.1
ttv,223,15,15,2,0,139.7,18,4,2,2,4797,1tap,paiN,MATCH,1,1.1
fpX,135,9,16,5,-7,90.1,19,0,4,-4,4797,1tap,paiN,MATCH,1,1.1
Random,126,10,14,2,-4,96.3,28,0,2,-2,4797,1tap,paiN,MATCH,1,1.1
ttv,123,8,16,3,-8,79.5,11,1,5,-4,4797,1tap,paiN,MATCH,1,1.1
murizzz,259,16,15,4,1,166.2,27,5,4,1,4797,paiN,1tap,MATCH,1,1.1
matheuzin,221,19,11,3,8,156.6,41,1,0,1,4797,paiN,1tap,MATCH,1,1.1
kon4n,194,15,13,2,2,95.1,32,4,2,2,4797,paiN,1tap,MATCH,1,1.1
Txozin,193,13,11,7,2,122.7,17,3,1,2,4797,paiN,1tap,MATCH,1,1.1
ole,164,13,11,6,2,116.5,19,0,1,-1,4797,paiN,1tap,MATCH,1,1.1
xand,280,66,50,13,16,154.9,19,11,11,0,4806,B4,paiN,MATCH,3,1.1
frz,233,60,41,23,19,134.7,25,6,0,6,4806,B4,paiN,MATCH,3,1.1
pancada,202,45,41,21,4,133.5,33,7,8,-1,4806,B4,paiN,MATCH,3,1.1
akemy,165,38,45,17,-7,101.1,12,1,6,-5,4806,B4,paiN,MATCH,3,1.1
v1nny,142,34,44,12,-10,91.9,20,6,12,-6,4806,B4,paiN,MATCH,3,1.1
kon4n,211,45,51,12,-6,134.4,24,6,4,2,4806,paiN,B4,MATCH,3,1.1
murizzz,192,46,49,8,-3,132.1,26,12,14,-2,4806,paiN,B4,MATCH,3,1.1
ole,189,45,45,18,0,115.9,10,3,2,1,4806,paiN,B4,MATCH,3,1.1
matheuzin,186,42,47,19,-5,123.8,28,11,5,6,4806,paiN,B4,MATCH,3,1.1
Txozin,165,43,51,9,-8,113.9,25,5,6,-1,4806,paiN,B4,MATCH,3,1.1
matheuzin,231,22,23,4,-1,153.6,42,3,7,-4,4772,paiN,RED,MATCH,1,1.1
kon4n,226,22,17,14,5,138.5,34,1,0,1,4772,paiN,RED,MATCH,1,1.1
murizzz,217,21,21,2,0,132.6,36,5,6,-1,4772,paiN,RED,MATCH,1,1.1
ole,196,17,21,12,-4,124.1,15,1,1,0,4772,paiN,RED,MATCH,1,1.1
Txozin,167,17,21,6,-4,102.0,18,2,2,0,4772,paiN,RED,MATCH,1,1.1
pepa,259,25,21,7,4,168.4,17,4,2,2,4772,RED,paiN,MATCH,1,1.1
Masu,236,24,19,8,5,145.8,26,3,2,1,4772,RED,paiN,MATCH,1,1.1
Sacy,212,21,17,17,4,134.8,23,2,1,1,4772,RED,paiN,MATCH,1,1.1
pollo,176,18,19,3,-1,104.2,18,4,2,2,4772,RED,paiN,MATCH,1,1.1
prozin,158,15,23,8,-8,92.1,28,3,5,-2,4772,RED,paiN,MATCH,1,1.1
mwzera,323,94,61,21,33,192.0,14,20,10,10,6687,GL,paiN,MATCH,4,1.12
Jonn,290,88,55,16,33,194.3,21,18,8,10,6687,GL,paiN,MATCH,4,1.12
fznnn,205,60,53,33,7,144.5,16,6,6,0,6687,GL,paiN,MATCH,4,1.12
Nyang,162,49,48,36,1,105.8,20,5,4,1,6687,GL,paiN,MATCH,4,1.12
JhoW,144,45,53,18,-8,92.5,16,3,6,-3,6687,GL,paiN,MATCH,4,1.12
kon4n,207,64,65,15,-1,128.5,25,3,7,-4,6687,paiN,GL,MATCH,4,1.12
Txozin,198,58,70,19,-12,123.6,20,7,7,0,6687,paiN,GL,MATCH,4,1.12
Veroneze,187,57,71,13,-14,116.7,26,8,21,-13,6687,paiN,GL,MATCH,4,1.12
murizzz,169,49,69,21,-20,104.5,20,11,10,1,6687,paiN,GL,MATCH,4,1.12
matheuzin,145,42,62,24,-20,101.5,19,5,7,-2,6687,paiN,GL,MATCH,4,1.12
pMdr1,235,34,33,5,1,144.5,27,8,6,2,6686,HAVAN,paiN,MATCH,2,1.12
bNhardneja,214,31,29,11,2,153.9,21,2,6,-4,6686,HAVAN,paiN,MATCH,2,1.12
shion,199,24,29,17,-5,125.0,25,3,1,2,6686,HAVAN,paiN,MATCH,2,1.12
pleets,194,24,34,11,-10,106.5,12,4,7,-3,6686,HAVAN,paiN,MATCH,2,1.12
Myssen,145,25,26,1,-1,91.9,43,0,3,-3,6686,HAVAN,paiN,MATCH,2,1.12
kon4n,279,38,28,19,10,173.4,30,6,3,3,6686,paiN,HAVAN,MATCH,2,1.12
Txozin,233,31,30,11,1,113.1,20,3,2,1,6686,paiN,HAVAN,MATCH,2,1.12
Veroneze,227,31,24,10,7,141.3,31,8,2,6,6686,paiN,HAVAN,MATCH,2,1.12
murizzz,216,33,27,15,6,132.7,18,2,5,-3,6686,paiN,HAVAN,MATCH,2,1.12
matheuzin,126,18,29,5,-11,82.5,29,4,5,-1,6686,paiN,HAVAN,MATCH,2,1.12
Veroneze,270,59,46,9,13,171.0,31,12,2,10,6684,paiN,IMP,MATCH,3,1.12
matheuzin,216,44,39,20,5,123.3,22,7,7,0,6684,paiN,IMP,MATCH,3,1.12
murizzz,197,43,42,9,1,118.3,25,9,8,1,6684,paiN,IMP,MATCH,3,1.12
kon4n,179,36,41,21,-5,117.2,24,3,5,-2,6684,paiN,IMP,MATCH,3,1.12
Txozin,176,37,37,13,0,126.2,17,5,5,0,6684,paiN,IMP,MATCH,3,1.12
Evilkyk,210,49,40,8,9,130.6,16,6,8,-2,6684,IMP,paiN,MATCH,3,1.12
txddy,198,46,44,10,2,125.1,22,3,6,-3,6684,IMP,paiN,MATCH,3,1.12
rst,193,38,43,18,-5,114.0,14,4,4,0,6684,IMP,paiN,MATCH,3,1.12
tuyz,187,38,42,16,-4,123.5,14,6,4,2,6684,IMP,paiN,MATCH,3,1.12
Biscoit1n,174,34,50,12,-16,96.3,21,8,14,-6,6684,IMP,paiN,MATCH,3,1.12
tuyz,242,41,31,13,10,142.0,20,8,9,-1,4629,Mix,paiN,MATCH,3,1.1
Evilkyk,237,40,33,18,7,144.0,21,9,2,7,4629,Mix,paiN,MATCH,3,1.1
txddy,231,42,31,14,11,142.4,19,5,3,2,4629,Mix,paiN,MATCH,3,1.1
Biscoit1n,219,40,32,11,8,119.4,22,7,5,2,4629,Mix,paiN,MATCH,3,1.1
rst,156,33,28,10,5,105.2,19,2,1,1,4629,Mix,paiN,MATCH,3,1.1
kon4n,209,38,40,9,-2,130.0,25,6,6,0,4629,paiN,Mix,MATCH,3,1.1
murizzz,198,33,43,10,-10,121.7,19,7,11,-4,4629,paiN,Mix,MATCH,3,1.1
matheuzin,170,32,40,10,-8,105.1,22,3,5,-2,4629,paiN,Mix,MATCH,3,1.1
ole,152,26,39,9,-13,97.3,16,2,6,-4,4629,paiN,Mix,MATCH,3,1.1
Txozin,145,26,35,8,-9,117.4,30,2,3,-1,4629,paiN,Mix,MATCH,3,1.1
glym,256,21,18,6,3,169.2,13,4,3,1,4621,K,paiN,MATCH,1,1.1
Tecnosh,203,18,22,4,-4,112.8,15,5,5,0,4621,K,paiN,MATCH,1,1.1
spacca,196,18,17,8,1,126.6,22,3,1,2,4621,K,paiN,MATCH,1,1.1
bezn1,189,18,16,7,2,134.0,20,0,3,-3,4621,K,paiN,MATCH,1,1.1
Tixinha,169,16,17,3,-1,104.8,14,0,2,-2,4621,K,paiN,MATCH,1,1.1
murizzz,279,25,17,4,8,166.2,14,4,4,0,4621,paiN,K,MATCH,1,1.1
Txozin,213,19,20,6,-1,119.5,33,4,3,1,4621,paiN,K,MATCH,1,1.1
matheuzin,205,15,19,11,-4,135.6,21,5,3,2,4621,paiN,K,MATCH,1,1.1
ole,203,20,15,4,5,125.3,15,0,0,0,4621,paiN,K,MATCH,1,1.1
kon4n,132,11,20,5,-9,99.9,27,1,2,-1,4621,paiN,K,MATCH,1,1.1
murizzz,258,71,59,11,12,157.9,21,20,8,12,3511,NOOR,GL,MATCH,4,1.09
kon4n,203,56,56,18,0,123.7,19,2,9,-7,3511,NOOR,GL,MATCH,4,1.09
ole,175,41,58,24,-17,111.2,15,5,4,1,3511,NOOR,GL,MATCH,4,1.09
matheuzin,173,55,55,15,0,118.4,31,4,10,-6,3511,NOOR,GL,MATCH,4,1.09
Txozin,136,39,57,20,-18,90.9,33,8,11,-3,3511,NOOR,GL,MATCH,4,1.09
mwzera,275,78,56,18,22,163.7,13,11,8,3,3511,GL,NOOR,MATCH,4,1.09
JhoW,189,51,54,26,-3,125.0,15,12,5,7,3511,GL,NOOR,MATCH,4,1.09
fznnn,185,52,49,28,3,120.9,29,5,13,-8,3511,GL,NOOR,MATCH,4,1.09
Jonn,185,53,55,22,-2,114.4,27,10,10,0,3511,GL,NOOR,MATCH,4,1.09
Nyang,165,51,48,21,3,96.4,15,4,3,1,3511,GL,NOOR,MATCH,4,1.09
Jonn,240,15,15,5,0,149.6,41,3,3,0,3508,GL,NOOR,MATCH,1,1.09
fznnn,236,13,12,4,1,156.3,26,2,0,2,3508,GL,NOOR,MATCH,1,1.09
mwzera,214,13,13,3,0,134.7,20,5,0,5,3508,GL,NOOR,MATCH,1,1.09
JhoW,130,8,13,1,-5,85.8,13,0,2,-2,3508,GL,NOOR,MATCH,1,1.09
Nyang,34,3,13,1,-10,16.3,14,1,2,-1,3508,GL,NOOR,MATCH,1,1.09
murizzz,463,31,9,3,22,257.1,19,5,0,5,3508,NOOR,GL,MATCH,1,1.09
ole,182,13,10,6,3,101.1,11,1,2,-1,3508,NOOR,GL,MATCH,1,1.09
kon4n,169,10,10,14,0,100.1,26,1,2,-1,3508,NOOR,GL,MATCH,1,1.09
matheuzin,113,6,10,10,-4,90.8,26,0,4,-4,3508,NOOR,GL,MATCH,1,1.09
Txozin,94,6,13,3,-7,62.6,25,0,3,-3,3508,NOOR,GL,MATCH,1,1.09
kon4n,358,24,13,5,11,274.5,19,5,0,5,3473,NOOR,VIMD,MATCH,1,1.09
murizzz,223,16,15,7,1,140.0,12,5,1,4,3473,NOOR,VIMD,MATCH,1,1.09
matheuzin,166,13,12,5,1,120.3,33,2,4,-2,3473,NOOR,VIMD,MATCH,1,1.09
Txozin,163,13,13,9,0,106.3,22,1,0,1,3473,NOOR,VIMD,MATCH,1,1.09
ole,125,9,12,2,-3,92.6,15,0,2,-2,3473,NOOR,VIMD,MATCH,1,1.09
pollo,327,24,16,4,8,155.8,21,4,2,2,3473,VIMD,NOOR,MATCH,1,1.09
Sacy,186,11,15,6,-4,127.7,26,0,1,-1,3473,VIMD,NOOR,MATCH,1,1.09
pepa,162,10,16,4,-6,111.4,14,1,4,-3,3473,VIMD,NOOR,MATCH,1,1.09
Masu,162,13,14,2,-1,102.2,16,1,0,1,3473,VIMD,NOOR,MATCH,1,1.09
prozin,108,6,14,5,-8,73.1,14,1,6,-5,3473,VIMD,NOOR,MATCH,1,1.09
pepa,307,51,26,10,25,209.6,24,4,1,3,9089,paiN,Agen,MATCH,2,2.01
murizzz,305,48,29,12,19,211.0,24,13,9,4,9089,paiN,Agen,MATCH,2,2.01
kon4n,189,31,27,13,4,141.8,24,2,0,2,9089,paiN,Agen,MATCH,2,2.01
matheuzin,188,28,35,12,-7,122.6,27,2,5,-3,9089,paiN,Agen,MATCH,2,2.01
ryotzz,137,21,31,13,-10,93.9,16,4,5,-1,9089,paiN,Agen,MATCH,2,2.01
cdziinxs1,297,38,42,21,-4,194.9,16,7,6,1,9089,Agen,paiN,MATCH,2,2.01
snw,244,38,41,6,-3,146.7,37,10,8,2,9089,Agen,paiN,MATCH,2,2.01
abA,166,28,35,10,-7,102.8,12,0,3,-3,9089,Agen,paiN,MATCH,2,2.01
fzz,161,25,33,7,-8,99.8,17,3,4,-1,9089,Agen,paiN,MATCH,2,2.01
vtz,107,17,28,13,-11,102.5,19,0,4,-4,9089,Agen,paiN,MATCH,2,2.01
murizzz,251,28,35,8,-7,172.0,19,6,8,-2,9101,paiN,VKS,MATCH,2,2.01
kon4n,175,23,29,10,-6,107.7,21,4,2,2,9101,paiN,VKS,MATCH,2,2.01
matheuzin,139,17,32,5,-15,90.0,20,4,4,0,9101,paiN,VKS,MATCH,2,2.01
pepa,114,11,31,11,-20,74.6,22,0,1,-1,9101,paiN,VKS,MATCH,2,2.01
ryotzz,96,10,28,2,-18,52.8,13,1,6,-5,9101,paiN,VKS,MATCH,2,2.01
gtnziN,312,38,21,13,17,197.2,21,8,2,6,9101,VKS,paiN,MATCH,2,2.01
frz,262,37,17,6,20,152.8,37,4,6,-2,9101,VKS,paiN,MATCH,2,2.01
sutecas,225,31,20,11,11,149.9,28,6,1,5,9101,VKS,paiN,MATCH,2,2.01
saadhak,205,28,14,9,14,106.8,8,2,3,-1,9101,VKS,paiN,MATCH,2,2.01
Sacy,177,20,17,17,3,128.1,22,1,3,-2,9101,VKS,paiN,MATCH,2,2.01
murizzz,234,15,18,7,-3,152.8,28,6,3,3,10287,paiN,HAVAN,MATCH,1,2.02
kon4n,226,12,16,11,-4,141.9,12,1,0,1,10287,paiN,HAVAN,MATCH,1,2.02
matheuzin,202,13,14,5,-1,130.4,18,0,0,0,10287,paiN,HAVAN,MATCH,1,2.02
pepa,139,10,17,4,-7,129.1,12,2,1,1,10287,paiN,HAVAN,MATCH,1,2.02
ryotzz,136,8,19,2,-11,88.5,12,1,5,-4,10287,paiN,HAVAN,MATCH,1,2.02
shion,345,22,12,10,10,216.2,24,3,3,0,10287,HAVAN,paiN,MATCH,1,2.02
pMdr1,279,22,9,4,13,145.9,42,1,2,-1,10287,HAVAN,paiN,MATCH,1,2.02
felipinho,263,17,16,7,1,147.6,11,3,2,1,10287,HAVAN,paiN,MATCH,1,2.02
Myssen,198,13,10,8,3,194.3,23,1,0,1,10287,HAVAN,paiN,MATCH,1,2.02
pleets,144,10,11,8,-1,129.7,18,1,3,-2,10287,HAVAN,paiN,MATCH,1,2.02
murizzz,256,21,19,5,2,150.7,39,5,4,1,10308,paiN,SLK,MATCH,1,2.02
kon4n,216,13,16,10,-3,159.8,23,2,1,1,10308,paiN,SLK,MATCH,1,2.02
pepa,177,14,14,7,0,147.4,28,2,2,0,10308,paiN,SLK,MATCH,1,2.02
ryotzz,176,15,15,5,0,96.0,5,1,3,-2,10308,paiN,SLK,MATCH,1,2.02
matheuzin,134,11,16,3,-5,85.7,15,0,3,-3,10308,paiN,SLK,MATCH,1,2.02
ntk,327,26,13,11,13,205.8,19,1,1,0,10308,SLK,paiN,MATCH,1,2.02
Hastad,243,16,20,8,-4,162.1,12,4,3,1,10308,SLK,paiN,MATCH,1,2.02
DiMAS,208,17,13,4,4,172.3,21,3,1,2,10308,SLK,paiN,MATCH,1,2.02
bld,143,12,12,5,0,173.7,29,2,3,-1,10308,SLK,paiN,MATCH,1,2.02
mNdS,132,9,16,10,-7,85.8,24,3,2,1,10308,SLK,paiN,MATCH,1,2.02
glym,292,20,8,5,12,172.2,20,1,1,0,12073,Rise,paiN,MATCH,1,2.03
Slag,290,19,13,2,6,161.0,37,6,3,3,12073,Rise,paiN,MATCH,1,2.03
GuhRVN,253,18,13,5,5,161.3,14,2,0,2,12073,Rise,paiN,MATCH,1,2.03
DmL,209,14,8,4,6,175.8,20,3,0,3,12073,Rise,paiN,MATCH,1,2.03
leonzhet,164,9,10,6,-1,101.6,24,1,1,0,12073,Rise,paiN,MATCH,1,2.03
pepa,231,14,17,4,-3,142.9,23,2,1,1,12073,paiN,Rise,MATCH,1,2.03
kon4n,212,12,17,5,-5,112.7,19,1,5,-4,12073,paiN,Rise,MATCH,1,2.03
matheuzin,200,13,14,5,-1,112.7,28,1,0,1,12073,paiN,Rise,MATCH,1,2.03
murizzz,151,9,15,4,-6,93.8,23,1,4,-3,12073,paiN,Rise,MATCH,1,2.03
ryotzz,94,4,17,2,-13,67.5,10,0,3,-3,12073,paiN,Rise,MATCH,1,2.03
NikkoLAN,215,29,39,10,-10,124.0,15,7,7,0,12076,FREE,paiN,MATCH,2,2.03
vhz,208,29,35,11,-6,125.3,36,4,5,-1,12076,FREE,paiN,MATCH,2,2.03
Fatal,186,24,34,8,-10,121.7,10,2,4,-2,12076,FREE,paiN,MATCH,2,2.03
FLG1,162,24,32,10,-8,107.0,38,2,5,-3,12076,FREE,paiN,MATCH,2,2.03
rood,149,22,29,11,-7,84.0,25,2,4,-2,12076,FREE,paiN,MATCH,2,2.03
kon4n,278,40,27,8,13,176.4,25,12,8,4,12076,paiN,FREE,MATCH,2,2.03
murizzz,257,38,28,10,10,163.0,22,7,5,2,12076,paiN,FREE,MATCH,2,2.03
matheuzin,240,36,23,17,13,141.3,31,3,1,2,12076,paiN,FREE,MATCH,2,2.03
pepa,189,31,24,6,7,123.0,35,1,1,0,12076,paiN,FREE,MATCH,2,2.03
ryotzz,167,24,26,10,-2,101.4,16,2,2,0,12076,paiN,FREE,MATCH,2,2.03
Slag,251,36,38,10,-2,164.2,22,7,8,-1,12080,Rise,paiN,MATCH,2,2.03
DmL,204,33,30,16,3,135.6,18,1,1,0,12080,Rise,paiN,MATCH,2,2.03
leonzhet,190,28,31,13,-3,119.4,16,5,4,1,12080,Rise,paiN,MATCH,2,2.03
glym,181,28,33,5,-5,102.0,15,7,8,-1,12080,Rise,paiN,MATCH,2,2.03
GuhRVN,159,22,35,15,-13,104.3,19,3,0,3,12080,Rise,paiN,MATCH,2,2.03
murizzz,265,47,27,16,20,153.0,22,4,9,-5,12080,paiN,Rise,MATCH,2,2.03
matheuzin,224,35,25,21,10,127.9,23,5,3,2,12080,paiN,Rise,MATCH,2,2.03
ryotzz,194,30,31,11,-1,115.8,11,4,2,2,12080,paiN,Rise,MATCH,2,2.03
kon4n,183,26,37,9,-11,121.8,12,6,8,-2,12080,paiN,Rise,MATCH,2,2.03
pepa,181,29,29,12,0,111.0,13,3,2,1,12080,paiN,Rise,MATCH,2,2.03
