Player,ACS,K,D,A,KD_DIFF,ADR,HS%,FK,FD,FK_FD_DIFF,match_id,Team,Opp_Team,Map,Num_maps,Patch
BRNWOWZK1,248,41,32,6,9,151.9,15,6,7,-1,12079,DLWZK,Sharks,MATCH,2,2.03
heat,240,42,32,4,10,154.4,28,4,4,0,12079,DLWZK,Sharks,MATCH,2,2.03
rhamurti,160,24,34,16,-10,108.6,20,4,6,-2,12079,DLWZK,Sharks,MATCH,2,2.03
zam,152,26,33,12,-7,103.3,13,3,3,0,12079,DLWZK,Sharks,MATCH,2,2.03
fluyr,102,14,33,11,-19,85.4,18,2,8,-6,12079,DLWZK,Sharks,MATCH,2,2.03
prozin,248,39,29,11,10,156.1,22,11,2,9,12079,Sharks,DLWZK,MATCH,2,2.03
fra,225,39,28,7,11,129.0,22,5,2,3,12079,Sharks,DLWZK,MATCH,2,2.03
deNaro,218,35,29,21,6,148.2,17,3,2,1,12079,Sharks,DLWZK,MATCH,2,2.03
gaabxx,200,31,32,12,-1,156.1,32,8,8,0,12079,Sharks,DLWZK,MATCH,2,2.03
light,140,20,29,14,-9,80.1,33,1,5,-4,12079,Sharks,DLWZK,MATCH,2,2.03
pancada,202,15,19,3,-4,129.3,26,4,2,2,12075,B4,Sharks,MATCH,1,2.03
Mazin,192,13,18,6,-5,145.5,40,2,2,0,12075,B4,Sharks,MATCH,1,2.03
fuzari,190,12,18,5,-6,116.7,15,0,3,-3,12075,B4,Sharks,MATCH,1,2.03
v1nny,146,11,15,7,-4,101.7,21,0,2,-2,12075,B4,Sharks,MATCH,1,2.03
dgzin,134,10,16,4,-6,88.4,30,2,4,-2,12075,B4,Sharks,MATCH,1,2.03
prozin,325,24,12,9,12,192.2,26,1,0,1,12075,Sharks,B4,MATCH,1,2.03
gaabxx,235,19,12,5,7,127.8,40,4,1,3,12075,Sharks,B4,MATCH,1,2.03
light,198,16,9,6,7,105.4,17,3,2,1,12075,Sharks,B4,MATCH,1,2.03
deNaro,194,15,13,2,2,120.0,39,3,2,1,12075,Sharks,B4,MATCH,1,2.03
fra,169,12,15,7,-3,106.2,26,2,3,-1,12075,Sharks,B4,MATCH,1,2.03
deNaro,310,40,14,22,26,168.5,27,3,0,3,11588,S5,JAG,MATCH,2,2.03
gaabxx,266,34,18,7,16,166.5,19,6,2,4,11588,S5,JAG,MATCH,2,2.03
prozin,246,31,21,12,10,142.4,7,6,5,1,11588,S5,JAG,MATCH,2,2.03
fra,212,28,18,13,10,132.3,25,5,3,2,11588,S5,JAG,MATCH,2,2.03
light,152,19,19,15,0,90.5,16,2,3,-1,11588,S5,JAG,MATCH,2,2.03
boltiNxd,186,21,30,8,-9,105.8,19,4,9,-5,11588,JAG,S5,MATCH,2,2.03
sant,175,17,32,14,-15,152.9,21,5,4,1,11588,JAG,S5,MATCH,2,2.03
Magic,159,16,33,8,-17,111.3,11,4,3,1,11588,JAG,S5,MATCH,2,2.03
AimGreen,158,19,30,5,-11,108.0,23,0,4,-4,11588,JAG,S5,MATCH,2,2.03
napz,128,17,27,6,-10,69.6,19,0,2,-2,11588,JAG,S5,MATCH,2,2.03
gaabxx,243,39,28,13,11,142.9,21,7,6,1,11583,S5,Inga,MATCH,2,2.03
deNaro,225,34,32,28,2,155.2,18,1,2,-1,11583,S5,Inga,MATCH,2,2.03
prozin,196,32,37,7,-5,114.5,27,9,11,-2,11583,S5,Inga,MATCH,2,2.03
light,180,31,32,14,-1,95.1,12,2,1,1,11583,S5,Inga,MATCH,2,2.03
fra,164,26,33,11,-7,104.5,19,2,6,-4,11583,S5,Inga,MATCH,2,2.03
patochovsk,243,38,31,14,7,162.4,22,6,3,3,11583,Inga,S5,MATCH,2,2.03
jacobin,237,39,33,17,6,137.7,17,6,1,5,11583,Inga,S5,MATCH,2,2.03
ceegu1N,206,34,31,12,3,119.3,17,5,4,1,11583,Inga,S5,MATCH,2,2.03
ducK,169,28,30,16,-2,107.2,22,2,2,0,11583,Inga,S5,MATCH,2,2.03
Pernalonga,146,23,37,9,-14,93.0,19,7,11,-4,11583,Inga,S5,MATCH,2,2.03
mwzera,247,34,33,14,1,163.5,20,9,5,4,10321,GL,S5,MATCH,2,2.02
Jonn,238,38,32,3,6,161.6,35,3,8,-5,10321,GL,S5,MATCH,2,2.02
JhoW,165,23,36,10,-13,137.4,17,2,2,0,10321,GL,S5,MATCH,2,2.02
fznnn,148,22,32,9,-10,99.3,16,0,8,-8,10321,GL,S5,MATCH,2,2.02
Nyang,141,19,35,8,-16,111.0,28,1,4,-3,10321,GL,S5,MATCH,2,2.02
prozin,281,37,29,18,8,167.8,15,11,5,6,10321,S5,GL,MATCH,2,2.02
gaabxx,245,37,28,7,9,146.3,21,10,4,6,10321,S5,GL,MATCH,2,2.02
light,207,34,28,19,6,125.6,20,1,0,1,10321,S5,GL,MATCH,2,2.02
deNaro,207,30,25,19,5,139.8,25,0,4,-4,10321,S5,GL,MATCH,2,2.02
fra,194,30,26,12,4,112.7,27,5,2,3,10321,S5,GL,MATCH,2,2.02
gaabxx,323,55,33,7,22,186.5,20,12,3,9,10320,S5,HAVAN,MATCH,2,2.02
prozin,272,42,32,10,10,163.3,22,8,3,5,10320,S5,HAVAN,MATCH,2,2.02
light,230,38,28,13,10,143.0,28,4,2,2,10320,S5,HAVAN,MATCH,2,2.02
deNaro,218,32,28,29,4,143.4,20,3,6,-3,10320,S5,HAVAN,MATCH,2,2.02
fra,108,16,32,18,-16,67.2,19,0,5,-5,10320,S5,HAVAN,MATCH,2,2.02
shion,310,46,33,18,13,175.4,17,3,1,2,10320,HAVAN,S5,MATCH,2,2.02
pMdr1,194,33,36,10,-3,110.2,14,3,7,-4,10320,HAVAN,S5,MATCH,2,2.02
felipinho,190,28,40,6,-12,116.8,23,9,5,4,10320,HAVAN,S5,MATCH,2,2.02
Myssen,176,30,36,7,-6,117.1,36,4,6,-2,10320,HAVAN,S5,MATCH,2,2.02
pleets,117,16,38,12,-22,75.0,14,0,8,-8,10320,HAVAN,S5,MATCH,2,2.02
Evilkyk,200,30,33,8,-3,128.5,25,4,7,-3,10307,IMP,S5,MATCH,2,2.02
Biscoit1n,198,32,35,7,-3,130.4,30,5,9,-4,10307,IMP,S5,MATCH,2,2.02
tuyz,189,30,32,4,-2,122.2,15,2,3,-1,10307,IMP,S5,MATCH,2,2.02
rst,173,23,32,11,-9,116.5,22,4,3,1,10307,IMP,S5,MATCH,2,2.02
gustt1nha,95,15,31,8,-16,66.5,27,0,8,-8,10307,IMP,S5,MATCH,2,2.02
prozin,287,46,25,8,21,177.6,19,7,3,4,10307,S5,IMP,MATCH,2,2.02
fra,217,34,23,6,11,141.6,22,2,2,0,10307,S5,IMP,MATCH,2,2.02
gaabxx,204,32,30,5,2,132.7,24,13,8,5,10307,S5,IMP,MATCH,2,2.02
light,182,28,29,12,-1,139.3,24,6,1,5,10307,S5,IMP,MATCH,2,2.02
deNaro,158,23,23,15,0,107.0,23,2,1,1,10307,S5,IMP,MATCH,2,2.02
Veroneze,246,18,14,3,4,126.5,26,6,1,5,10305,Vivo,S5,MATCH,1,2.02
PryZee,230,14,17,6,-3,155.2,17,0,1,-1,10305,Vivo,S5,MATCH,1,2.02
Zap,213,13,14,6,-1,173.9,25,1,1,0,10305,Vivo,S5,MATCH,1,2.02
Cpx,181,13,16,7,-3,96.5,26,1,3,-2,10305,Vivo,S5,MATCH,1,2.02
Maverick,121,5,17,6,-12,90.3,26,3,2,1,10305,Vivo,S5,MATCH,1,2.02
deNaro,309,18,13,15,5,176.6,13,1,2,-1,10305,S5,Vivo,MATCH,1,2.02
gaabxx,231,16,14,4,2,127.9,18,2,5,-3,10305,S5,Vivo,MATCH,1,2.02
prozin,225,14,13,9,1,150.1,31,3,4,-1,10305,S5,Vivo,MATCH,1,2.02
fra,216,15,12,4,3,123.1,9,1,0,1,10305,S5,Vivo,MATCH,1,2.02
light,204,15,11,8,4,111.0,17,1,0,1,10305,S5,Vivo,MATCH,1,2.02
deNaro,221,41,39,24,2,149.7,15,4,3,1,9427,S5,IMP,MATCH,2,2.01
gaabxx,210,43,39,6,4,135.4,26,11,5,6,9427,S5,IMP,MATCH,2,2.01
prozin,205,40,44,15,-4,127.0,17,8,6,2,9427,S5,IMP,MATCH,2,2.01
fooX,191,41,41,11,0,134.6,18,3,4,-1,9427,S5,IMP,MATCH,2,2.01
fra,181,36,46,13,-10,107.8,16,6,8,-2,9427,S5,IMP,MATCH,2,2.01
tuyz,277,53,39,18,14,167.9,31,2,4,-2,9427,IMP,S5,MATCH,2,2.01
Evilkyk,237,48,37,17,11,178.2,44,7,5,2,9427,IMP,S5,MATCH,2,2.01
Biscoit1n,206,40,48,12,-8,146.7,26,15,13,2,9427,IMP,S5,MATCH,2,2.01
rst,193,39,38,13,1,128.0,26,1,6,-5,9427,IMP,S5,MATCH,2,2.01
gustt1nha,148,29,39,13,-10,100.3,26,1,4,-3,9427,IMP,S5,MATCH,2,2.01
prozin,265,35,34,4,1,148.1,18,5,6,-1,9425,S5,VKS,MATCH,2,2.01
gaabxx,202,25,31,10,-6,175.3,27,6,7,-1,9425,S5,VKS,MATCH,2,2.01
fra,159,20,36,4,-16,101.6,28,2,6,-4,9425,S5,VKS,MATCH,2,2.01
deNaro,157,20,31,10,-11,121.7,18,0,4,-4,9425,S5,VKS,MATCH,2,2.01
fooX,144,18,31,5,-13,108.7,26,1,1,0,9425,S5,VKS,MATCH,2,2.01
gtnziN,292,38,25,14,13,197.9,18,5,4,1,9425,VKS,S5,MATCH,2,2.01
frz,282,40,23,12,17,150.9,21,8,4,4,9425,VKS,S5,MATCH,2,2.01
Sacy,234,29,24,29,5,153.1,20,6,2,4,9425,VKS,S5,MATCH,2,2.01
saadhak,224,32,21,11,11,135.0,27,4,2,2,9425,VKS,S5,MATCH,2,2.01
sutecas,163,24,25,6,-1,98.3,40,1,2,-1,9425,VKS,S5,MATCH,2,2.01
fluyr,252,22,13,2,9,134.5,14,2,1,1,9261,DLWZK,S5,MATCH,1,2.01
BRNWOWZK1,245,16,16,7,0,147.7,12,0,1,-1,9261,DLWZK,S5,MATCH,1,2.01
rhamurti,227,12,17,12,-5,136.0,13,4,3,1,9261,DLWZK,S5,MATCH,1,2.01
heat,182,14,16,3,-2,104.4,31,3,2,1,9261,DLWZK,S5,MATCH,1,2.01
zam,157,10,14,6,-4,80.3,15,2,2,0,9261,DLWZK,S5,MATCH,1,2.01
prozin,338,20,15,6,5,207.0,15,4,1,3,9261,S5,DLWZK,MATCH,1,2.01
fooX,235,19,14,8,5,136.6,18,1,0,1,9261,S5,DLWZK,MATCH,1,2.01
fra,185,13,19,2,-6,111.3,21,1,1,0,9261,S5,DLWZK,MATCH,1,2.01
deNaro,170,14,11,6,3,101.8,29,0,0,0,9261,S5,DLWZK,MATCH,1,2.01
gaabxx,150,10,15,3,-5,89.8,22,3,9,-6,9261,S5,DLWZK,MATCH,1,2.01
aspas,262,35,34,11,1,156.9,25,11,5,6,9330,fave,S5,MATCH,2,2.01
akemy,195,30,29,2,1,133.5,25,4,3,1,9330,fave,S5,MATCH,2,2.01
cad,187,23,33,9,-10,125.1,14,1,2,-1,9330,fave,S5,MATCH,2,2.01
prince,170,23,31,11,-8,116.8,26,3,5,-2,9330,fave,S5,MATCH,2,2.01
Nether,84,13,33,3,-20,58.9,28,0,6,-6,9330,fave,S5,MATCH,2,2.01
deNaro,257,41,19,15,22,149.4,21,2,3,-1,9330,S5,fave,MATCH,2,2.01
prozin,256,33,24,14,9,142.5,21,7,6,1,9330,S5,fave,MATCH,2,2.01
gaabxx,241,30,31,15,-1,147.6,25,9,6,3,9330,S5,fave,MATCH,2,2.01
fooX,223,29,23,21,6,156.2,24,1,2,-1,9330,S5,fave,MATCH,2,2.01
fra,174,27,27,8,0,108.4,23,2,2,0,9330,S5,fave,MATCH,2,2.01
jayp,214,49,50,30,-1,137.8,22,3,8,-5,9329,Barr,S5,MATCH,3,2.01
jowzikk,203,47,58,13,-11,139.0,26,14,13,1,9329,Barr,S5,MATCH,3,2.01
chunbs,188,43,53,13,-10,132.0,26,4,8,-4,9329,Barr,S5,MATCH,3,2.01
Leox,182,41,53,18,-12,107.0,19,8,9,-1,9329,Barr,S5,MATCH,3,2.01
gbr,165,37,46,13,-9,131.2,16,1,0,1,9329,Barr,S5,MATCH,3,2.01
prozin,318,68,44,25,24,191.9,22,7,8,-1,9329,S5,Barr,MATCH,3,2.01
deNaro,219,46,41,41,5,138.2,19,6,1,5,9329,S5,Barr,MATCH,3,2.01
gaabxx,213,50,45,15,5,130.6,27,15,10,5,9329,S5,Barr,MATCH,3,2.01
fooX,193,50,47,18,3,114.3,21,6,6,0,9329,S5,Barr,MATCH,3,2.01
fra,165,46,41,8,5,105.5,23,4,5,-1,9329,S5,Barr,MATCH,3,2.01
