Player,ACS,K,D,A,KD_DIFF,ADR,HS%,FK,FD,FK_FD_DIFF,match_id,Team,Opp_Team,Map,Num_maps,Patch
mwzera,294,40,25,11,15,188.9,21,9,2,7,6797,GL,IMP,MATCH,2,1.12
Jonn,274,34,23,10,11,137.4,20,5,3,2,6797,GL,IMP,MATCH,2,1.12
JhoW,207,30,24,12,6,128.4,14,3,3,0,6797,GL,IMP,MATCH,2,1.12
fznnn,174,24,24,15,0,104.8,16,4,6,-2,6797,GL,IMP,MATCH,2,1.12
Nyang,160,22,22,11,0,100.1,24,1,2,-1,6797,GL,IMP,MATCH,2,1.12
txddy,220,31,31,4,0,130.2,26,1,5,-4,6797,IMP,GL,MATCH,2,1.12
Biscoit1n,194,23,34,6,-11,114.5,16,5,8,-3,6797,IMP,GL,MATCH,2,1.12
tuyz,190,22,28,5,-6,122.3,18,5,3,2,6797,IMP,GL,MATCH,2,1.12
rst,172,23,26,7,-3,132.9,24,2,2,0,6797,IMP,GL,MATCH,2,1.12
Evilkyk,159,18,31,14,-13,109.6,24,3,4,-1,6797,IMP,GL,MATCH,2,1.12
Masu,239,34,29,3,5,136.9,31,2,1,1,6526,RED,GL,MATCH,2,
FV,148,22,36,8,-14,102.0,17,4,8,-4,6526,RED,GL,MATCH,2,
pepa,146,19,34,16,-15,94.3,17,2,2,0,6526,RED,GL,MATCH,2,
pollo,143,21,29,6,-8,96.7,24,2,5,-3,6526,RED,GL,MATCH,2,
prozin,114,16,34,12,-18,77.2,20,6,8,-2,6526,RED,GL,MATCH,2,
mwzera,329,46,24,12,22,198.0,21,5,5,0,6526,GL,RED,MATCH,2,
Jonn,297,43,23,8,20,141.3,23,9,5,4,6526,GL,RED,MATCH,2,
fznnn,216,30,20,14,10,116.2,23,5,3,2,6526,GL,RED,MATCH,2,
JhoW,204,24,25,20,-1,128.0,15,3,1,2,6526,GL,RED,MATCH,2,
Nyang,126,19,20,17,-1,82.9,21,2,2,0,6526,GL,RED,MATCH,2,
mwzera,320,37,19,10,18,186.8,14,6,3,3,6052,GL,FKL,MATCH,2,1.12
Jonn,307,38,21,4,17,178.5,24,9,4,5,6052,GL,FKL,MATCH,2,1.12
JhoW,247,34,15,7,19,148.5,25,3,0,3,6052,GL,FKL,MATCH,2,1.12
fznnn,232,27,17,9,10,124.6,22,2,3,-1,6052,GL,FKL,MATCH,2,1.12
Nyang,116,13,19,17,-6,78.5,20,0,3,-3,6052,GL,FKL,MATCH,2,1.12
qck,233,24,30,6,-6,133.9,12,7,10,-3,6052,FKL,GL,MATCH,2,1.12
Khalil,184,19,30,11,-11,119.0,13,0,2,-2,6052,FKL,GL,MATCH,2,1.12
bld,171,21,29,6,-8,108.5,19,2,2,0,6052,FKL,GL,MATCH,2,1.12
pava,161,17,29,8,-12,100.3,10,1,3,-2,6052,FKL,GL,MATCH,2,1.12
mch,92,10,31,2,-21,87.4,30,3,3,0,6052,FKL,GL,MATCH,2,1.12
mwzera,222,27,28,3,-1,125.7,18,4,3,1,3214,GL,FF,MATCH,2,1.08
Jonn,173,20,31,8,-11,104.6,18,4,11,-7,3214,GL,FF,MATCH,2,1.08
fznnn,160,18,30,7,-12,111.1,21,0,3,-3,3214,GL,FF,MATCH,2,1.08
JhoW,126,14,33,8,-19,85.4,13,1,4,-3,3214,GL,FF,MATCH,2,1.08
Nyang,126,17,26,5,-9,83.9,31,3,5,-2,3214,GL,FF,MATCH,2,1.08
fzkk,326,39,23,10,16,176.9,9,10,3,7,3214,FF,GL,MATCH,2,1.08
delevingne,212,30,20,5,10,136.4,24,6,5,1,3214,FF,GL,MATCH,2,1.08
krain,203,27,19,15,8,141.1,17,4,1,3,3214,FF,GL,MATCH,2,1.08
v1xen,179,28,16,10,12,108.2,21,3,2,1,3214,FF,GL,MATCH,2,1.08
dragonite,171,24,18,9,6,122.9,28,3,1,2,3214,FF,GL,MATCH,2,1.08
frz,222,14,14,5,0,117.1,17,3,1,2,3144,B4,GL,MATCH,1,1.08
xand,186,14,16,0,-2,133.4,25,1,4,-3,3144,B4,GL,MATCH,1,1.08
akemy,154,11,16,0,-5,74.9,16,2,2,0,3144,B4,GL,MATCH,1,1.08
v1nny,146,10,17,7,-7,83.9,5,1,5,-4,3144,B4,GL,MATCH,1,1.08
pancada,145,10,14,7,-4,91.9,17,0,1,-1,3144,B4,GL,MATCH,1,1.08
Jonn,327,24,11,5,13,175.7,27,1,1,0,3144,GL,B4,MATCH,1,1.08
mwzera,286,20,14,4,6,157.8,19,10,2,8,3144,GL,B4,MATCH,1,1.08
fznnn,194,14,12,8,2,123.6,14,2,2,0,3144,GL,B4,MATCH,1,1.08
JhoW,165,11,11,9,0,112.0,14,0,0,0,3144,GL,B4,MATCH,1,1.08
Nyang,108,8,11,8,-3,62.2,12,0,2,-2,3144,GL,B4,MATCH,1,1.08
Tecnosh,282,19,15,2,4,186.1,20,3,2,1,3050,FAKE,GL,MATCH,1,1.08
NANZIN,194,11,14,4,-3,122.9,35,2,4,-2,3050,FAKE,GL,MATCH,1,1.08
patochovsk,161,11,14,4,-3,88.3,20,1,3,-2,3050,FAKE,GL,MATCH,1,1.08
GTFAFMX,159,13,13,4,0,97.0,20,0,2,-2,3050,FAKE,GL,MATCH,1,1.08
FLG1,127,8,16,6,-8,83.1,27,2,1,1,3050,FAKE,GL,MATCH,1,1.08
Jonn,301,21,13,4,8,184.2,39,5,1,4,3050,GL,FAKE,MATCH,1,1.08
JhoW,279,19,12,10,7,165.0,17,3,0,3,3050,GL,FAKE,MATCH,1,1.08
mwzera,223,16,13,4,3,139.3,9,2,3,-1,3050,GL,FAKE,MATCH,1,1.08
fznnn,135,9,11,6,-2,88.8,19,2,3,-1,3050,GL,FAKE,MATCH,1,1.08
Nyang,103,7,13,8,-6,64.9,11,0,1,-1,3050,GL,FAKE,MATCH,1,1.08
Jonn,260,35,27,7,8,147.3,34,4,4,0,2976,GL,QUEM,MATCH,2,1.08
mwzera,240,31,18,5,13,131.3,11,7,3,4,2976,GL,QUEM,MATCH,2,1.08
JhoW,203,24,20,13,4,120.0,15,3,2,1,2976,GL,QUEM,MATCH,2,1.08
Nyang,192,26,17,9,9,111.7,29,5,0,5,2976,GL,QUEM,MATCH,2,1.08
fznnn,142,16,22,16,-6,99.8,14,1,6,-5,2976,GL,QUEM,MATCH,2,1.08
And,243,29,26,6,3,160.8,19,0,3,-3,2976,QUEM,GL,MATCH,2,1.08
DonPablito,189,20,25,5,-5,119.9,14,5,3,2,2976,QUEM,GL,MATCH,2,1.08
LGAAAAA,171,20,25,9,-5,109.9,16,3,2,1,2976,QUEM,GL,MATCH,2,1.08
spacebound,160,18,28,5,-10,95.2,12,2,7,-5,2976,QUEM,GL,MATCH,2,1.08
luq1w,143,17,28,5,-11,85.3,13,5,5,0,2976,QUEM,GL,MATCH,2,1.08
mwzera,548,53,10,8,43,296.1,16,10,1,9,2954,GL,Mind,MATCH,2,1.08
Jonn,242,25,10,9,15,163.2,36,0,2,-2,2954,GL,Mind,MATCH,2,1.08
fznnn,214,19,8,10,11,127.6,12,7,2,5,2954,GL,Mind,MATCH,2,1.08
Nyang,183,21,6,11,15,118.7,30,0,3,-3,2954,GL,Mind,MATCH,2,1.08
JhoW,116,11,4,13,7,68.3,14,1,0,1,2954,GL,Mind,MATCH,2,1.08
Stormixxx,132,10,27,1,-17,74.9,8,3,8,-5,2954,Mind,GL,MATCH,2,1.08
haru1,122,10,26,1,-16,67.8,15,1,4,-3,2954,Mind,GL,MATCH,2,1.08
v1ny,105,8,26,2,-18,71.0,31,2,1,1,2954,Mind,GL,MATCH,2,1.08
Harpyja,73,6,24,1,-18,41.9,17,1,1,0,2954,Mind,GL,MATCH,2,1.08
Edon,64,4,26,0,-22,43.5,13,1,4,-3,2954,Mind,GL,MATCH,2,1.08
mwzera,298,48,31,7,17,164.9,7,12,8,4,3140,GL,B4,MATCH,2,1.08
Jonn,207,31,35,14,-4,126.1,17,6,9,-3,3140,GL,B4,MATCH,2,1.08
Nyang,195,30,23,22,7,138.0,22,2,2,0,3140,GL,B4,MATCH,2,1.08
JhoW,184,31,27,14,4,116.2,9,0,1,-1,3140,GL,B4,MATCH,2,1.08
fznnn,175,25,25,20,0,110.5,21,2,2,0,3140,GL,B4,MATCH,2,1.08
frz,268,44,27,7,17,172.8,17,2,3,-1,3140,B4,GL,MATCH,2,1.08
xand,261,40,36,10,4,157.0,19,5,7,-2,3140,B4,GL,MATCH,2,1.08
v1nny,158,22,35,11,-13,94.2,19,6,5,1,3140,B4,GL,MATCH,2,1.08
pancada,138,18,32,11,-14,85.6,20,6,4,2,3140,B4,GL,MATCH,2,1.08
akemy,117,15,35,14,-20,89.2,21,3,3,0,3140,B4,GL,MATCH,2,1.08
mwzera,274,23,16,6,7,158.7,15,6,1,5,3062,GL,VIMD,MATCH,1,1.08
Jonn,243,18,18,8,0,166.8,38,6,5,1,3062,GL,VIMD,MATCH,1,1.08
fznnn,191,13,21,7,-8,132.8,19,0,1,-1,3062,GL,VIMD,MATCH,1,1.08
JhoW,170,15,17,6,-2,96.2,13,2,0,2,3062,GL,VIMD,MATCH,1,1.08
Nyang,96,9,17,9,-8,67.5,21,1,1,0,3062,GL,VIMD,MATCH,1,1.08
Sacy,330,27,16,7,11,187.5,35,2,2,0,3062,VIMD,GL,MATCH,1,1.08
pepa,235,20,17,8,3,145.0,29,2,1,1,3062,VIMD,GL,MATCH,1,1.08
pollo,232,21,13,1,8,142.9,24,4,2,2,3062,VIMD,GL,MATCH,1,1.08
Masu,181,14,14,8,0,127.0,29,0,2,-2,3062,VIMD,GL,MATCH,1,1.08
prozin,117,7,18,7,-11,84.8,18,0,8,-8,3062,VIMD,GL,MATCH,1,1.08
xand,217,12,15,5,-3,141.4,16,2,1,1,3051,B4,GL,MATCH,1,1.08
pancada,169,11,14,4,-3,109.5,27,0,3,-3,3051,B4,GL,MATCH,1,1.08
v1nny,165,11,14,3,-3,114.3,25,2,2,0,3051,B4,GL,MATCH,1,1.08
frz,156,9,14,6,-5,84.6,17,1,1,0,3051,B4,GL,MATCH,1,1.08
akemy,109,7,13,3,-6,61.1,29,1,5,-4,3051,B4,GL,MATCH,1,1.08
fznnn,295,18,10,11,8,184.8,25,6,1,5,3051,GL,B4,MATCH,1,1.08
mwzera,258,16,10,3,6,132.3,4,2,0,2,3051,GL,B4,MATCH,1,1.08
JhoW,246,16,9,8,7,137.0,12,1,3,-2,3051,GL,B4,MATCH,1,1.08
Jonn,185,13,9,5,4,125.7,30,2,1,1,3051,GL,B4,MATCH,1,1.08
Nyang,115,7,12,6,-5,78.5,19,1,1,0,3051,GL,B4,MATCH,1,1.08
deNaro,198,14,16,5,-2,119.7,8,2,2,0,2940,VKS,GL,MATCH,1,1.08
gtnziN,197,16,16,4,0,112.1,31,1,0,1,2940,VKS,GL,MATCH,1,1.08
fuzari,196,14,13,2,1,109.2,16,1,2,-1,2940,VKS,GL,MATCH,1,1.08
cad,168,14,15,1,-1,111.0,22,3,5,-2,2940,VKS,GL,MATCH,1,1.08
BrinkssJ,134,8,18,9,-10,83.2,20,2,3,-1,2940,VKS,GL,MATCH,1,1.08
mwzera,282,22,13,3,9,152.1,24,4,4,0,2940,GL,VKS,MATCH,1,1.08
fznnn,222,15,12,10,3,148.6,18,4,1,3,2940,GL,VKS,MATCH,1,1.08
Nyang,220,19,13,3,6,119.2,28,2,1,1,2940,GL,VKS,MATCH,1,1.08
Jonn,181,11,13,8,-2,125.0,34,2,3,-1,2940,GL,VKS,MATCH,1,1.08
JhoW,148,11,15,11,-4,100.3,11,0,0,0,2940,GL,VKS,MATCH,1,1.08
saadhak,237,21,15,9,6,164.3,28,3,0,3,2930,Estral,GL,MATCH,1,1.08
Nozwerr,212,21,17,4,4,141.8,18,2,3,-1,2930,Estral,GL,MATCH,1,1.08
Pel√©,201,18,21,14,-3,123.8,10,3,2,1,2930,Estral,GL,MATCH,1,1.08
NagZ,169,15,21,1,-6,114.8,19,3,4,-1,2930,Estral,GL,MATCH,1,1.08
Leazo,163,14,22,5,-8,115.5,20,3,3,0,2930,Estral,GL,MATCH,1,1.08
mwzera,274,23,17,7,6,170.8,14,2,4,-2,2930,GL,Estral,MATCH,1,1.08
Nyang,215,20,21,13,-1,138.6,15,1,2,-1,2930,GL,Estral,MATCH,1,1.08
fznnn,212,18,17,6,1,142.1,23,2,2,0,2930,GL,Estral,MATCH,1,1.08
JhoW,195,19,16,9,3,129.3,12,4,2,2,2930,GL,Estral,MATCH,1,1.08
Jonn,181,16,18,9,-2,106.7,41,3,4,-1,2930,GL,Estral,MATCH,1,1.08
mwzera,351,40,24,6,16,196.5,15,10,3,7,3510,GL,VIMD,MATCH,2,1.09
Jonn,284,34,17,9,17,157.2,42,3,1,2,3510,GL,VIMD,MATCH,2,1.09
JhoW,177,21,15,14,6,114.0,10,3,2,1,3510,GL,VIMD,MATCH,2,1.09
fznnn,168,20,14,16,6,118.9,23,4,1,3,3510,GL,VIMD,MATCH,2,1.09
Nyang,154,21,16,8,5,80.2,21,3,3,0,3510,GL,VIMD,MATCH,2,1.09
Sacy,222,23,26,6,-3,133.5,20,2,3,-1,3510,VIMD,GL,MATCH,2,1.09
pollo,192,21,27,3,-6,120.8,24,3,5,-2,3510,VIMD,GL,MATCH,2,1.09
pepa,172,19,27,7,-8,110.1,32,3,6,-3,3510,VIMD,GL,MATCH,2,1.09
prozin,138,14,28,5,-14,93.2,14,1,2,-1,3510,VIMD,GL,MATCH,2,1.09
Masu,96,9,28,10,-19,67.8,10,1,7,-6,3510,VIMD,GL,MATCH,2,1.09
Jonn,240,15,15,5,0,149.6,41,3,3,0,3508,GL,NOOR,MATCH,1,1.09
fznnn,236,13,12,4,1,156.3,26,2,0,2,3508,GL,NOOR,MATCH,1,1.09
mwzera,214,13,13,3,0,134.7,20,5,0,5,3508,GL,NOOR,MATCH,1,1.09
JhoW,130,8,13,1,-5,85.8,13,0,2,-2,3508,GL,NOOR,MATCH,1,1.09
Nyang,34,3,13,1,-10,16.3,14,1,2,-1,3508,GL,NOOR,MATCH,1,1.09
murizzz,463,31,9,3,22,257.1,19,5,0,5,3508,NOOR,GL,MATCH,1,1.09
ole,182,13,10,6,3,101.1,11,1,2,-1,3508,NOOR,GL,MATCH,1,1.09
kon4n,169,10,10,14,0,100.1,26,1,2,-1,3508,NOOR,GL,MATCH,1,1.09
matheuzin,113,6,10,10,-4,90.8,26,0,4,-4,3508,NOOR,GL,MATCH,1,1.09
Txozin,94,6,13,3,-7,62.6,25,0,3,-3,3508,NOOR,GL,MATCH,1,1.09
Jonn,276,24,19,7,5,158.1,39,3,4,-1,3472,GL,Estral,MATCH,1,1.09
fznnn,264,21,13,7,8,170.1,27,1,1,0,3472,GL,Estral,MATCH,1,1.09
mwzera,214,18,20,5,-2,144.6,18,2,6,-4,3472,GL,Estral,MATCH,1,1.09
Nyang,189,18,12,9,6,125.6,21,1,1,0,3472,GL,Estral,MATCH,1,1.09
JhoW,127,11,17,2,-6,70.8,6,0,5,-5,3472,GL,Estral,MATCH,1,1.09
NagZ,260,23,16,1,7,146.6,22,7,0,7,3472,Estral,GL,MATCH,1,1.09
saadhak,238,18,20,5,-2,162.9,13,7,2,5,3472,Estral,GL,MATCH,1,1.09
Nozwerr,222,19,18,4,1,138.8,30,2,1,1,3472,Estral,GL,MATCH,1,1.09
Leazo,132,11,20,7,-9,90.4,10,1,2,-1,3472,Estral,GL,MATCH,1,1.09
puleule,115,10,18,14,-8,85.4,18,0,2,-2,3472,Estral,GL,MATCH,1,1.09
mwzera,278,25,20,6,5,162.2,9,3,0,3,3466,GL,novi,MATCH,1,1.09
Jonn,253,23,20,6,3,147.7,27,6,7,-1,3466,GL,novi,MATCH,1,1.09
fznnn,244,23,14,10,9,216.9,36,1,1,0,3466,GL,novi,MATCH,1,1.09
JhoW,168,15,19,6,-4,84.8,12,2,0,2,3466,GL,novi,MATCH,1,1.09
Nyang,105,8,19,9,-11,64.3,27,1,5,-4,3466,GL,novi,MATCH,1,1.09
Biscoit1n,241,21,22,5,-1,147.7,20,4,4,0,3466,novi,GL,MATCH,1,1.09
Enjoy,229,21,18,4,3,133.0,12,4,1,3,3466,novi,GL,MATCH,1,1.09
kato,211,20,18,3,2,145.2,20,1,1,0,3466,novi,GL,MATCH,1,1.09
Fxz,176,16,17,3,-1,119.0,28,3,2,1,3466,novi,GL,MATCH,1,1.09
glym,132,13,19,4,-6,92.7,29,1,5,-4,3466,novi,GL,MATCH,1,1.09
mwzera,323,94,61,21,33,192.0,14,20,10,10,6687,GL,paiN,MATCH,4,1.12
Jonn,290,88,55,16,33,194.3,21,18,8,10,6687,GL,paiN,MATCH,4,1.12
fznnn,205,60,53,33,7,144.5,16,6,6,0,6687,GL,paiN,MATCH,4,1.12
Nyang,162,49,48,36,1,105.8,20,5,4,1,6687,GL,paiN,MATCH,4,1.12
JhoW,144,45,53,18,-8,92.5,16,3,6,-3,6687,GL,paiN,MATCH,4,1.12
kon4n,207,64,65,15,-1,128.5,25,3,7,-4,6687,paiN,GL,MATCH,4,1.12
Txozin,198,58,70,19,-12,123.6,20,7,7,0,6687,paiN,GL,MATCH,4,1.12
Veroneze,187,57,71,13,-14,116.7,26,8,21,-13,6687,paiN,GL,MATCH,4,1.12
murizzz,169,49,69,21,-20,104.5,20,11,10,1,6687,paiN,GL,MATCH,4,1.12
matheuzin,145,42,62,24,-20,101.5,19,5,7,-2,6687,paiN,GL,MATCH,4,1.12
mwzera,294,41,30,10,11,163.7,12,10,1,9,6685,GL,B4,MATCH,2,1.12
Jonn,247,41,27,7,14,146.6,20,10,4,6,6685,GL,B4,MATCH,2,1.12
fznnn,229,31,27,19,4,134.4,27,2,3,-1,6685,GL,B4,MATCH,2,1.12
Nyang,192,27,23,21,4,119.3,19,0,4,-4,6685,GL,B4,MATCH,2,1.12
JhoW,178,24,26,24,-2,109.0,10,2,6,-4,6685,GL,B4,MATCH,2,1.12
pancada,264,36,32,11,4,187.2,23,8,4,4,6685,B4,GL,MATCH,2,1.12
xand,222,29,33,8,-4,149.6,18,6,10,-4,6685,B4,GL,MATCH,2,1.12
frz,205,30,30,15,0,135.6,30,2,2,0,6685,B4,GL,MATCH,2,1.12
akemy,140,22,32,18,-10,80.0,17,1,2,-1,6685,B4,GL,MATCH,2,1.12
v1nny,117,16,37,7,-21,74.1,17,1,6,-5,6685,B4,GL,MATCH,2,1.12
mwzera,377,45,26,13,19,220.0,15,6,4,2,6681,GL,Inga,MATCH,2,1.12
JhoW,208,26,18,17,8,144.4,21,2,3,-1,6681,GL,Inga,MATCH,2,1.12
Jonn,201,25,24,11,1,124.5,19,5,8,-3,6681,GL,Inga,MATCH,2,1.12
Nyang,176,26,15,8,11,98.8,21,2,1,1,6681,GL,Inga,MATCH,2,1.12
fznnn,167,17,16,15,1,107.0,29,2,1,1,6681,GL,Inga,MATCH,2,1.12
ducK,247,31,27,5,4,147.8,21,6,0,6,6681,Inga,GL,MATCH,2,1.12
jacobin,206,24,29,15,-5,111.9,32,6,3,3,6681,Inga,GL,MATCH,2,1.12
dio9x,160,17,27,6,-10,104.6,17,2,3,-1,6681,Inga,GL,MATCH,2,1.12
Pernalonga,141,15,29,7,-14,92.9,11,3,3,0,6681,Inga,GL,MATCH,2,1.12
ceegu1N,110,12,27,9,-15,71.2,9,0,8,-8,6681,Inga,GL,MATCH,2,1.12
mpg,197,9,15,6,-6,132.1,17,3,2,1,4767,ANA,GL,MATCH,1,1.1
GuhRVN,197,12,14,1,-2,119.4,21,0,1,-1,4767,ANA,GL,MATCH,1,1.1
tockers,160,8,15,5,-7,94.8,14,1,0,1,4767,ANA,GL,MATCH,1,1.1
rankioshi,148,8,13,2,-5,92.8,13,4,4,0,4767,ANA,GL,MATCH,1,1.1
xikaz,82,4,14,3,-10,50.6,11,0,1,-1,4767,ANA,GL,MATCH,1,1.1
mwzera,360,20,13,3,7,181.6,11,2,0,2,4767,GL,ANA,MATCH,1,1.1
Jonn,260,15,8,2,7,167.6,26,3,3,0,4767,GL,ANA,MATCH,1,1.1
Nyang,219,16,6,9,10,190.0,28,0,1,-1,4767,GL,ANA,MATCH,1,1.1
JhoW,194,11,8,3,3,176.9,9,1,1,0,4767,GL,ANA,MATCH,1,1.1
fznnn,149,9,8,3,1,94.1,14,2,3,-1,4767,GL,ANA,MATCH,1,1.1
mwzera,252,42,33,16,9,146.7,15,5,1,4,5261,GL,Tagl,MATCH,3,1.12
fznnn,230,40,30,21,10,146.7,23,8,3,5,5261,GL,Tagl,MATCH,3,1.12
Jonn,217,40,37,5,3,123.5,26,6,7,-1,5261,GL,Tagl,MATCH,3,1.12
Nyang,168,34,33,10,1,111.5,27,4,5,-1,5261,GL,Tagl,MATCH,3,1.12
JhoW,160,28,33,14,-5,92.1,21,6,5,1,5261,GL,Tagl,MATCH,3,1.12
Slaag,215,36,43,10,-7,145.0,24,8,9,-1,5261,Tagl,GL,MATCH,3,1.12
rankioshi,214,38,35,6,3,116.3,13,7,7,0,5261,Tagl,GL,MATCH,3,1.12
xikaz,196,35,36,16,-1,124.2,22,3,4,-1,5261,Tagl,GL,MATCH,3,1.12
fells,174,30,35,19,-5,108.4,22,2,3,-1,5261,Tagl,GL,MATCH,3,1.12
rik,154,25,35,4,-10,96.3,22,1,6,-5,5261,Tagl,GL,MATCH,3,1.12
mwzera,278,48,37,9,11,167.7,19,6,5,1,5277,GL,Gala,MATCH,2,1.12
Jonn,261,41,36,11,5,173.6,31,12,5,7,5277,GL,Gala,MATCH,2,1.12
fznnn,215,36,29,11,7,121.5,22,6,3,3,5277,GL,Gala,MATCH,2,1.12
Nyang,208,34,30,19,4,121.1,20,1,2,-1,5277,GL,Gala,MATCH,2,1.12
JhoW,138,22,31,15,-9,84.3,13,1,6,-5,5277,GL,Gala,MATCH,2,1.12
axeddy,247,36,39,15,-3,162.3,12,10,7,3,5277,Gala,GL,MATCH,2,1.12
zakkv,222,37,37,18,0,130.7,17,2,3,-1,5277,Gala,GL,MATCH,2,1.12
p√¥ti,220,38,34,13,4,133.0,21,1,3,-2,5277,Gala,GL,MATCH,2,1.12
Double,194,30,37,17,-7,121.9,18,6,6,0,5277,Gala,GL,MATCH,2,1.12
mcn,127,22,34,10,-12,84.6,12,2,7,-5,5277,Gala,GL,MATCH,2,1.12
fznnn,287,19,8,5,11,169.4,9,0,1,-1,2703,GL,Qiss,MATCH,1,1.07
mwzera,287,16,10,3,6,160.4,16,4,0,4,2703,GL,Qiss,MATCH,1,1.07
JhoW,200,14,7,3,7,116.2,13,1,0,1,2703,GL,Qiss,MATCH,1,1.07
Jonn,169,10,14,3,-4,103.7,19,4,5,-1,2703,GL,Qiss,MATCH,1,1.07
Nyang,152,10,7,6,3,85.9,24,2,0,2,2703,GL,Qiss,MATCH,1,1.07
vett,240,12,13,5,-1,153.8,20,0,0,0,2703,Qiss,GL,MATCH,1,1.07
rafz,240,13,13,3,0,159.1,31,2,1,1,2703,Qiss,GL,MATCH,1,1.07
one1,160,8,16,3,-8,97.6,9,1,3,-2,2703,Qiss,GL,MATCH,1,1.07
mpg,134,7,14,1,-7,84.2,11,2,5,-3,2703,Qiss,GL,MATCH,1,1.07
doodlez,107,6,13,2,-7,71.3,21,1,2,-1,2703,Qiss,GL,MATCH,1,1.07
cad,224,17,17,3,0,131.9,18,1,1,0,2737,VKS,GL,MATCH,1,1.07
fuzari,214,17,15,4,2,114.5,32,2,1,1,2737,VKS,GL,MATCH,1,1.07
deNaro,193,16,16,6,0,125.5,22,2,4,-2,2737,VKS,GL,MATCH,1,1.07
BrinkssJ,173,11,14,13,-3,125.4,25,1,0,1,2737,VKS,GL,MATCH,1,1.07
gtnziN,158,10,19,5,-9,105.6,24,3,7,-4,2737,VKS,GL,MATCH,1,1.07
JhoW,282,24,11,7,13,168.6,14,3,3,0,2737,GL,VKS,MATCH,1,1.07
mwzera,223,18,15,4,3,133.6,12,5,2,3,2737,GL,VKS,MATCH,1,1.07
Jonn,202,13,18,9,-5,120.1,33,1,2,-1,2737,GL,VKS,MATCH,1,1.07
Nyang,172,14,12,11,2,97.3,23,1,1,0,2737,GL,VKS,MATCH,1,1.07
fznnn,166,12,15,8,-3,117.1,13,3,1,2,2737,GL,VKS,MATCH,1,1.07
fznnn,231,15,14,6,1,126.4,32,1,3,-2,2712,GL,VIMD,MATCH,1,1.07
mwzera,204,15,17,5,-2,113.4,21,1,2,-1,2712,GL,VIMD,MATCH,1,1.07
Jonn,203,13,17,2,-4,109.5,37,3,1,2,2712,GL,VIMD,MATCH,1,1.07
JhoW,138,9,17,2,-8,78.1,8,2,1,1,2712,GL,VIMD,MATCH,1,1.07
Nyang,129,7,17,6,-10,92.0,18,3,2,1,2712,GL,VIMD,MATCH,1,1.07
Sacy,334,26,10,5,16,182.5,17,4,1,3,2712,VIMD,GL,MATCH,1,1.07
pollo,288,20,13,5,7,169.2,19,4,4,0,2712,VIMD,GL,MATCH,1,1.07
pepa,250,16,12,8,4,175.6,20,0,0,0,2712,VIMD,GL,MATCH,1,1.07
Masu,179,11,10,9,1,108.6,18,0,2,-2,2712,VIMD,GL,MATCH,1,1.07
prozin,175,9,14,10,-5,111.6,10,1,3,-2,2712,VIMD,GL,MATCH,1,1.07
Jonn,259,58,53,17,5,159.1,26,9,5,4,2744,GL,FF,MATCH,3,1.08
mwzera,208,51,53,9,-2,130.6,13,12,9,3,2744,GL,FF,MATCH,3,1.08
fznnn,182,42,44,19,-2,115.3,18,2,10,-8,2744,GL,FF,MATCH,3,1.08
JhoW,153,35,52,16,-17,113.3,12,7,6,1,2744,GL,FF,MATCH,3,1.08
Nyang,109,24,49,26,-25,85.8,10,2,4,-2,2744,GL,FF,MATCH,3,1.08
fzkk,253,53,45,25,8,162.9,16,8,11,-3,2744,FF,GL,MATCH,3,1.08
v1xen,220,54,42,22,12,132.4,17,7,6,1,2744,FF,GL,MATCH,3,1.08
krain,212,50,36,19,14,132.4,18,4,2,2,2744,FF,GL,MATCH,3,1.08
delevingne,204,46,50,20,-4,138.5,20,11,7,4,2744,FF,GL,MATCH,3,1.08
dragonite,189,46,40,16,6,120.7,23,4,6,-2,2744,FF,GL,MATCH,3,1.08
Leox,236,57,50,19,7,155.5,13,13,10,3,2764,DG,GL,MATCH,2,1.08
francez,216,60,55,11,5,133.6,25,8,4,4,2764,DG,GL,MATCH,2,1.08
Veroneze,215,55,53,12,2,136.1,22,14,14,0,2764,DG,GL,MATCH,2,1.08
Khalil,170,39,54,25,-15,110.0,13,4,4,0,2764,DG,GL,MATCH,2,1.08
JotaM,165,45,45,30,0,127.8,21,1,2,-1,2764,DG,GL,MATCH,2,1.08
mwzera,253,66,55,7,11,154.7,14,16,12,4,2764,GL,DG,MATCH,2,1.08
Jonn,222,58,55,26,3,146.7,24,7,7,0,2764,GL,DG,MATCH,2,1.08
fznnn,200,45,49,39,-4,141.9,23,5,9,-4,2764,GL,DG,MATCH,2,1.08
JhoW,191,47,49,25,-2,124.1,16,2,6,-4,2764,GL,DG,MATCH,2,1.08
Nyang,147,40,48,20,-8,94.3,19,4,6,-2,2764,GL,DG,MATCH,2,1.08
mwzera,355,53,28,13,25,197.7,15,3,0,3,10261,GL,Urub,MATCH,2,2.02
Jonn,269,41,29,14,12,163.0,27,11,5,6,10261,GL,Urub,MATCH,2,2.02
fznnn,221,30,26,15,4,126.0,24,6,2,4,10261,GL,Urub,MATCH,2,2.02
Nyang,174,28,23,8,5,121.5,20,3,4,-1,10261,GL,Urub,MATCH,2,2.02
JhoW,140,21,28,8,-7,84.4,19,2,6,-4,10261,GL,Urub,MATCH,2,2.02
szk,251,36,35,8,1,158.2,28,5,4,1,10261,Urub,GL,MATCH,2,2.02
paix,199,29,33,9,-4,149.8,27,0,3,-3,10261,Urub,GL,MATCH,2,2.02
Way,188,24,31,19,-7,124.0,20,2,2,0,10261,Urub,GL,MATCH,2,2.02
hiccz,168,24,37,6,-13,114.0,15,9,15,-6,10261,Urub,GL,MATCH,2,2.02
iamlucasss,149,21,37,13,-16,96.1,14,1,1,0,10261,Urub,GL,MATCH,2,2.02
mwzera,317,67,46,12,21,224.2,21,11,8,3,10292,GL,Gala,MATCH,3,2.02
fznnn,210,43,37,27,6,121.5,21,4,4,0,10292,GL,Gala,MATCH,3,2.02
Jonn,209,43,42,12,1,136.3,27,9,11,-2,10292,GL,Gala,MATCH,3,2.02
JhoW,146,29,42,17,-13,96.0,15,6,4,2,10292,GL,Gala,MATCH,3,2.02
Nyang,146,32,41,23,-9,84.8,22,0,3,-3,10292,GL,Gala,MATCH,3,2.02
p√¥ti,223,50,40,15,10,144.4,33,3,0,3,10292,Gala,GL,MATCH,3,2.02
Tisora,203,44,42,19,2,124.4,19,6,6,0,10292,Gala,GL,MATCH,3,2.02
zakkv,201,43,40,15,3,127.4,13,7,8,-1,10292,Gala,GL,MATCH,3,2.02
axeddy,189,37,48,19,-11,118.9,19,8,13,-5,10292,Gala,GL,MATCH,3,2.02
Double,162,33,44,8,-11,115.2,14,6,3,3,10292,Gala,GL,MATCH,3,2.02
Jonn,436,30,13,6,17,268.3,26,5,1,4,10285,GL,Vivo,MATCH,1,2.02
mwzera,266,19,16,7,3,145.3,17,3,4,-1,10285,GL,Vivo,MATCH,1,2.02
fznnn,193,15,9,11,6,109.8,14,1,1,0,10285,GL,Vivo,MATCH,1,2.02
JhoW,149,12,14,4,-2,96.8,21,0,2,-2,10285,GL,Vivo,MATCH,1,2.02
Nyang,136,8,13,6,-5,83.9,11,1,2,-1,10285,GL,Vivo,MATCH,1,2.02
Zap,209,14,15,9,-1,140.3,20,1,2,-1,10285,Vivo,GL,MATCH,1,2.02
PryZee,205,13,19,4,-6,127.6,27,4,3,1,10285,Vivo,GL,MATCH,1,2.02
Maverick,199,15,16,3,-1,111.4,30,0,1,-1,10285,Vivo,GL,MATCH,1,2.02
Veroneze,173,13,17,3,-4,106.3,31,4,4,0,10285,Vivo,GL,MATCH,1,2.02
Cpx,167,10,17,4,-7,97.5,19,1,0,1,10285,Vivo,GL,MATCH,1,2.02
mwzera,315,22,13,7,9,256.0,18,5,1,4,10306,GL,IMP,MATCH,1,2.02
Nyang,234,19,12,9,7,148.0,16,2,1,1,10306,GL,IMP,MATCH,1,2.02
Jonn,195,14,15,4,-1,147.3,25,3,3,0,10306,GL,IMP,MATCH,1,2.02
fznnn,193,15,11,5,4,107.3,6,1,1,0,10306,GL,IMP,MATCH,1,2.02
JhoW,193,13,15,5,-2,106.2,10,3,1,2,10306,GL,IMP,MATCH,1,2.02
Evilkyk,268,18,18,8,0,152.0,28,1,1,0,10306,IMP,GL,MATCH,1,2.02
rst,215,16,16,3,0,127.4,12,4,3,1,10306,IMP,GL,MATCH,1,2.02
tuyz,192,15,14,7,1,126.2,26,1,1,0,10306,IMP,GL,MATCH,1,2.02
Biscoit1n,129,10,16,1,-6,137.6,21,0,5,-5,10306,IMP,GL,MATCH,1,2.02
gustt1nha,125,7,19,6,-12,85.0,29,1,4,-3,10306,IMP,GL,MATCH,1,2.02
Nozwerr,244,16,15,10,1,161.5,12,2,1,1,10340,FURI,GL,MATCH,1,2.02
qck,227,18,14,6,4,151.7,21,1,2,-1,10340,FURI,GL,MATCH,1,2.02
xand,222,18,16,5,2,128.8,20,4,2,2,10340,FURI,GL,MATCH,1,2.02
txddy,181,13,15,6,-2,94.0,21,3,5,-2,10340,FURI,GL,MATCH,1,2.02
Khalil,142,11,17,4,-6,96.6,10,1,1,0,10340,FURI,GL,MATCH,1,2.02
mwzera,299,24,14,4,10,186.0,21,2,3,-1,10340,GL,FURI,MATCH,1,2.02
JhoW,238,21,12,2,9,127.6,13,4,1,3,10340,GL,FURI,MATCH,1,2.02
Jonn,220,16,20,5,-4,109.8,15,4,5,-1,10340,GL,FURI,MATCH,1,2.02
Nyang,129,8,14,16,-6,83.6,15,0,1,-1,10340,GL,FURI,MATCH,1,2.02
fznnn,115,8,16,9,-8,83.0,11,1,1,0,10340,GL,FURI,MATCH,1,2.02
Jonn,369,48,23,12,25,206.6,28,8,2,6,10319,GL,SLK,MATCH,2,2.02
mwzera,265,36,22,5,14,151.9,15,9,4,5,10319,GL,SLK,MATCH,2,2.02
fznnn,202,23,18,20,5,126.8,14,3,3,0,10319,GL,SLK,MATCH,2,2.02
JhoW,195,26,19,15,7,116.1,10,3,3,0,10319,GL,SLK,MATCH,2,2.02
Nyang,173,23,19,17,4,102.1,18,0,1,-1,10319,GL,SLK,MATCH,2,2.02
Hastad,261,28,32,12,-4,168.2,13,4,5,-1,10319,SLK,GL,MATCH,2,2.02
DiMAS,164,21,32,6,-11,107.1,38,3,4,-1,10319,SLK,GL,MATCH,2,2.02
ntk,160,17,31,11,-14,103.7,12,1,3,-2,10319,SLK,GL,MATCH,2,2.02
bld,136,18,30,4,-12,77.9,20,4,5,-1,10319,SLK,GL,MATCH,2,2.02
mNdS,133,17,31,6,-14,87.0,20,1,6,-5,10319,SLK,GL,MATCH,2,2.02
mwzera,247,34,33,14,1,163.5,20,9,5,4,10321,GL,S5,MATCH,2,2.02
Jonn,238,38,32,3,6,161.6,35,3,8,-5,10321,GL,S5,MATCH,2,2.02
JhoW,165,23,36,10,-13,137.4,17,2,2,0,10321,GL,S5,MATCH,2,2.02
fznnn,148,22,32,9,-10,99.3,16,0,8,-8,10321,GL,S5,MATCH,2,2.02
Nyang,141,19,35,8,-16,111.0,28,1,4,-3,10321,GL,S5,MATCH,2,2.02
prozin,281,37,29,18,8,167.8,15,11,5,6,10321,S5,GL,MATCH,2,2.02
gaabxx,245,37,28,7,9,146.3,21,10,4,6,10321,S5,GL,MATCH,2,2.02
light,207,34,28,19,6,125.6,20,1,0,1,10321,S5,GL,MATCH,2,2.02
deNaro,207,30,25,19,5,139.8,25,0,4,-4,10321,S5,GL,MATCH,2,2.02
fra,194,30,26,12,4,112.7,27,5,2,3,10321,S5,GL,MATCH,2,2.02
GuhRVN,279,33,28,7,5,179.1,28,3,2,1,10343,Rise,GL,MATCH,2,2.02
Slag,234,29,30,10,-1,151.2,33,5,3,2,10343,Rise,GL,MATCH,2,2.02
leonzhet,158,17,32,13,-15,106.8,30,0,3,-3,10343,Rise,GL,MATCH,2,2.02
glym,144,18,33,8,-15,96.5,16,1,10,-9,10343,Rise,GL,MATCH,2,2.02
DmL,86,10,33,9,-23,52.8,19,2,9,-7,10343,Rise,GL,MATCH,2,2.02
mwzera,297,43,25,6,18,205.2,17,7,2,5,10343,GL,Rise,MATCH,2,2.02
Jonn,257,36,25,5,11,159.2,29,11,2,9,10343,GL,Rise,MATCH,2,2.02
fznnn,247,32,21,12,11,174.3,25,4,2,2,10343,GL,Rise,MATCH,2,2.02
Nyang,201,23,21,26,2,138.3,20,4,3,1,10343,GL,Rise,MATCH,2,2.02
JhoW,138,22,15,4,7,83.6,22,1,2,-1,10343,GL,Rise,MATCH,2,2.02
